day,day_of_week,date,page_loads,unique_visits,first_time_visits,returning_visits
Sunday,1,2014-09-14,2146,1582,1430,152
Monday,2,2014-09-15,3621,2528,2297,231
Tuesday,3,2014-09-16,3698,2630,2352,278
Wednesday,4,2014-09-17,3667,2614,2327,287
Thursday,5,2014-09-18,3316,2366,2130,236
Friday,6,2014-09-19,2815,1863,1622,241
Saturday,7,2014-09-20,1658,1118,985,133
Sunday,1,2014-09-21,2288,1656,1481,175
Monday,2,2014-09-22,3638,2586,2312,274
Tuesday,3,2014-09-23,4462,3257,2989,268
Wednesday,4,2014-09-24,4414,3175,2891,284
Thursday,5,2014-09-25,4315,3029,2743,286
Friday,6,2014-09-26,3323,2249,2033,216
Saturday,7,2014-09-27,1656,1180,1040,140
Sunday,1,2014-09-28,2465,1806,1613,193
Monday,2,2014-09-29,4096,2873,2577,296
Tuesday,3,2014-09-30,4474,3032,2720,312
Wednesday,4,2014-10-01,4124,2849,2541,308
Thursday,5,2014-10-02,3514,2489,2239,250
Friday,6,2014-10-03,3005,2097,1856,241
Saturday,7,2014-10-04,2054,1436,1274,162
Sunday,1,2014-10-05,2847,1913,1713,200
Monday,2,2014-10-06,4501,3181,2853,328
Tuesday,3,2014-10-07,4603,3163,2804,359
Wednesday,4,2014-10-08,4187,3014,2663,351
Thursday,5,2014-10-09,4343,2864,2545,319
Friday,6,2014-10-10,3565,2382,2100,282
Saturday,7,2014-10-11,2080,1457,1280,177
Sunday,1,2014-10-12,3031,2089,1856,233
Monday,2,2014-10-13,4814,3339,2973,366
Tuesday,3,2014-10-14,5040,3604,3217,387
Wednesday,4,2014-10-15,5028,3515,3094,421
Thursday,5,2014-10-16,4658,3331,2955,376
Friday,6,2014-10-17,3624,2477,2148,329
Saturday,7,2014-10-18,2285,1619,1416,203
Sunday,1,2014-10-19,3454,2346,2060,286
Monday,2,2014-10-20,5307,3717,3308,409
Tuesday,3,2014-10-21,5135,3701,3280,421
Wednesday,4,2014-10-22,5084,3611,3177,434
Thursday,5,2014-10-23,4650,3316,2940,376
Friday,6,2014-10-24,3571,2498,2170,328
Saturday,7,2014-10-25,2354,1661,1417,244
Sunday,1,2014-10-26,3497,2508,2218,290
Monday,2,2014-10-27,5294,3737,3286,451
Tuesday,3,2014-10-28,4643,3328,2905,423
Wednesday,4,2014-10-29,4596,3279,2863,416
Thursday,5,2014-10-30,4162,3041,2657,384
Friday,6,2014-10-31,2933,2007,1728,279
Saturday,7,2014-11-01,2202,1496,1270,226
Sunday,1,2014-11-02,3083,2204,1940,264
Monday,2,2014-11-03,4376,3057,2629,428
Tuesday,3,2014-11-04,4704,3141,2739,402
Wednesday,4,2014-11-05,4306,3200,2797,403
Thursday,5,2014-11-06,4178,3034,2627,407
Friday,6,2014-11-07,3236,2318,1975,343
Saturday,7,2014-11-08,2010,1536,1345,191
Sunday,1,2014-11-09,2901,2141,1849,292
Monday,2,2014-11-10,4754,3325,2885,440
Tuesday,3,2014-11-11,4417,3203,2793,410
Wednesday,4,2014-11-12,4535,3351,2897,454
Thursday,5,2014-11-13,4274,3194,2758,436
Friday,6,2014-11-14,3382,2423,2061,362
Saturday,7,2014-11-15,2085,1488,1280,208
Sunday,1,2014-11-16,3083,2215,1926,289
Monday,2,2014-11-17,4860,3559,3069,490
Tuesday,3,2014-11-18,4893,3570,3133,437
Wednesday,4,2014-11-19,4866,3544,3056,488
Thursday,5,2014-11-20,4584,3357,2899,458
Friday,6,2014-11-21,3914,2750,2361,389
Saturday,7,2014-11-22,2431,1716,1463,253
Sunday,1,2014-11-23,3157,2369,2082,287
Monday,2,2014-11-24,5045,3615,3146,469
Tuesday,3,2014-11-25,4746,3236,2821,415
Wednesday,4,2014-11-26,4314,2919,2513,406
Thursday,5,2014-11-27,3663,2476,2162,314
Friday,6,2014-11-28,3270,2268,1931,337
Saturday,7,2014-11-29,2905,1976,1695,281
Sunday,1,2014-11-30,4016,2832,2489,343
Monday,2,2014-12-01,5266,3877,3317,560
Tuesday,3,2014-12-02,5795,4274,3700,574
Wednesday,4,2014-12-03,5728,4217,3656,561
Thursday,5,2014-12-04,5293,3830,3295,535
Friday,6,2014-12-05,3934,2856,2479,377
Saturday,7,2014-12-06,3071,2165,1855,310
Sunday,1,2014-12-07,3876,2984,2582,402
Monday,2,2014-12-08,5878,4375,3829,546
Tuesday,3,2014-12-09,5712,4187,3635,552
Wednesday,4,2014-12-10,5491,4074,3480,594
Thursday,5,2014-12-11,5144,3801,3247,554
Friday,6,2014-12-12,3880,2860,2418,442
Saturday,7,2014-12-13,2605,1838,1538,300
Sunday,1,2014-12-14,3625,2650,2259,391
Monday,2,2014-12-15,4685,3478,3000,478
Tuesday,3,2014-12-16,4891,3338,2861,477
Wednesday,4,2014-12-17,4222,3053,2606,447
Thursday,5,2014-12-18,3691,2690,2275,415
Friday,6,2014-12-19,2748,1879,1559,320
Saturday,7,2014-12-20,1380,1011,836,175
Sunday,1,2014-12-21,1474,1054,876,178
Monday,2,2014-12-22,2452,1715,1394,321
Tuesday,3,2014-12-23,2298,1440,1159,281
Wednesday,4,2014-12-24,1430,947,772,175
Thursday,5,2014-12-25,1002,667,522,145
Friday,6,2014-12-26,1486,1005,808,197
Saturday,7,2014-12-27,1345,941,781,160
Sunday,1,2014-12-28,1453,948,765,183
Monday,2,2014-12-29,2173,1472,1228,244
Tuesday,3,2014-12-30,2208,1424,1172,252
Wednesday,4,2014-12-31,1381,955,773,182
Thursday,5,2015-01-01,1265,876,715,161
Friday,6,2015-01-02,1948,1288,1030,258
Saturday,7,2015-01-03,1742,1096,946,150
Sunday,1,2015-01-04,1896,1409,1186,223
Monday,2,2015-01-05,3033,2062,1706,356
Tuesday,3,2015-01-06,3445,2327,1942,385
Wednesday,4,2015-01-07,3423,2384,1991,393
Thursday,5,2015-01-08,3319,2272,1922,350
Friday,6,2015-01-09,2783,1941,1663,278
Saturday,7,2015-01-10,1952,1240,1066,174
Sunday,1,2015-01-11,2245,1611,1391,220
Monday,2,2015-01-12,3928,2518,2125,393
Tuesday,3,2015-01-13,3810,2621,2239,382
Wednesday,4,2015-01-14,3931,2656,2229,427
Thursday,5,2015-01-15,3523,2457,2069,388
Friday,6,2015-01-16,2943,1928,1640,288
Saturday,7,2015-01-17,1751,1237,1052,185
Sunday,1,2015-01-18,2491,1762,1541,221
Monday,2,2015-01-19,3766,2665,2271,394
Tuesday,3,2015-01-20,4194,2852,2423,429
Wednesday,4,2015-01-21,4038,2916,2482,434
Thursday,5,2015-01-22,3891,2702,2334,368
Friday,6,2015-01-23,3111,2181,1897,284
Saturday,7,2015-01-24,1946,1414,1239,175
Sunday,1,2015-01-25,2802,2010,1740,270
Monday,2,2015-01-26,3892,2841,2466,375
Tuesday,3,2015-01-27,4172,3003,2592,411
Wednesday,4,2015-01-28,4464,3280,2862,418
Thursday,5,2015-01-29,4377,3143,2679,464
Friday,6,2015-01-30,3734,2514,2129,385
Saturday,7,2015-01-31,2262,1657,1443,214
Sunday,1,2015-02-01,3050,2122,1825,297
Monday,2,2015-02-02,4794,3366,2867,499
Tuesday,3,2015-02-03,4936,3423,2922,501
Wednesday,4,2015-02-04,5016,3500,3023,477
Thursday,5,2015-02-05,4489,3170,2753,417
Friday,6,2015-02-06,3505,2468,2075,393
Saturday,7,2015-02-07,2264,1679,1437,242
Sunday,1,2015-02-08,3314,2435,2100,335
Monday,2,2015-02-09,5095,3619,3125,494
Tuesday,3,2015-02-10,5525,3793,3272,521
Wednesday,4,2015-02-11,5074,3689,3190,499
Thursday,5,2015-02-12,4571,3319,2810,509
Friday,6,2015-02-13,3570,2664,2253,411
Saturday,7,2015-02-14,2182,1565,1323,242
Sunday,1,2015-02-15,3265,2277,1935,342
Monday,2,2015-02-16,4670,3297,2826,471
Tuesday,3,2015-02-17,4764,3452,2957,495
Wednesday,4,2015-02-18,4943,3526,3026,500
Thursday,5,2015-02-19,4790,3307,2811,496
Friday,6,2015-02-20,3604,2621,2241,380
Saturday,7,2015-02-21,2455,1823,1569,254
Sunday,1,2015-02-22,3650,2690,2329,361
Monday,2,2015-02-23,5463,3975,3433,542
Tuesday,3,2015-02-24,5884,4112,3542,570
Wednesday,4,2015-02-25,5615,4019,3432,587
Thursday,5,2015-02-26,5289,3747,3186,561
Friday,6,2015-02-27,4434,2969,2486,483
Saturday,7,2015-02-28,2665,1977,1694,283
Sunday,1,2015-03-01,3907,2906,2519,387
Monday,2,2015-03-02,5308,3778,3222,556
Tuesday,3,2015-03-03,5773,4025,3490,535
Wednesday,4,2015-03-04,5585,4060,3457,603
Thursday,5,2015-03-05,4783,3582,3049,533
Friday,6,2015-03-06,3893,2707,2259,448
Saturday,7,2015-03-07,2917,2048,1723,325
Sunday,1,2015-03-08,3353,2468,2104,364
Monday,2,2015-03-09,5400,3824,3246,578
Tuesday,3,2015-03-10,5395,3926,3350,576
Wednesday,4,2015-03-11,5229,3859,3263,596
Thursday,5,2015-03-12,5371,3784,3204,580
Friday,6,2015-03-13,4185,3045,2559,486
Saturday,7,2015-03-14,2724,1988,1675,313
Sunday,1,2015-03-15,3590,2620,2196,424
Monday,2,2015-03-16,5367,3771,3192,579
Tuesday,3,2015-03-17,5440,3968,3387,581
Wednesday,4,2015-03-18,5465,4043,3458,585
Thursday,5,2015-03-19,5318,3813,3262,551
Friday,6,2015-03-20,4225,2916,2462,454
Saturday,7,2015-03-21,2687,1975,1667,308
Sunday,1,2015-03-22,3791,2786,2388,398
Monday,2,2015-03-23,5661,3949,3331,618
Tuesday,3,2015-03-24,5759,4081,3487,594
Wednesday,4,2015-03-25,5599,3983,3378,605
Thursday,5,2015-03-26,5103,3755,3184,571
Friday,6,2015-03-27,4313,2946,2446,500
Saturday,7,2015-03-28,2971,2011,1651,360
Sunday,1,2015-03-29,3662,2693,2285,408
Monday,2,2015-03-30,5635,3985,3386,599
Tuesday,3,2015-03-31,5581,3963,3359,604
Wednesday,4,2015-04-01,5329,3761,3170,591
Thursday,5,2015-04-02,4553,3214,2710,504
Friday,6,2015-04-03,3423,2404,1988,416
Saturday,7,2015-04-04,2708,1807,1512,295
Sunday,1,2015-04-05,3306,2266,1895,371
Monday,2,2015-04-06,5203,3692,3133,559
Tuesday,3,2015-04-07,5712,4104,3456,648
Wednesday,4,2015-04-08,5601,4015,3401,614
Thursday,5,2015-04-09,5486,4063,3430,633
Friday,6,2015-04-10,4178,3213,2697,516
Saturday,7,2015-04-11,2878,2153,1835,318
Sunday,1,2015-04-12,4169,2903,2447,456
Monday,2,2015-04-13,6372,4485,3787,698
Tuesday,3,2015-04-14,6240,4391,3698,693
Wednesday,4,2015-04-15,6170,4409,3723,686
Thursday,5,2015-04-16,6071,4275,3586,689
Friday,6,2015-04-17,4682,3307,2741,566
Saturday,7,2015-04-18,3208,2291,1894,397
Sunday,1,2015-04-19,4310,3144,2669,475
Monday,2,2015-04-20,6435,4694,3929,765
Tuesday,3,2015-04-21,6299,4455,3769,686
Wednesday,4,2015-04-22,6360,4512,3797,715
Thursday,5,2015-04-23,6349,4360,3664,696
Friday,6,2015-04-24,4660,3387,2845,542
Saturday,7,2015-04-25,3354,2420,2035,385
Sunday,1,2015-04-26,4371,3189,2688,501
Monday,2,2015-04-27,6534,4731,3977,754
Tuesday,3,2015-04-28,6832,4941,4161,780
Wednesday,4,2015-04-29,6689,4870,4110,760
Thursday,5,2015-04-30,5849,4086,3450,636
Friday,6,2015-05-01,4247,3064,2562,502
Saturday,7,2015-05-02,3219,2360,1958,402
Sunday,1,2015-05-03,4211,3210,2765,445
Monday,2,2015-05-04,6424,4752,4043,709
Tuesday,3,2015-05-05,6223,4520,3818,702
Wednesday,4,2015-05-06,6551,4768,4059,709
Thursday,5,2015-05-07,6343,4449,3770,679
Friday,6,2015-05-08,4696,3366,2824,542
Saturday,7,2015-05-09,3134,2239,1846,393
Sunday,1,2015-05-10,3868,2844,2365,479
Monday,2,2015-05-11,6020,4482,3787,695
Tuesday,3,2015-05-12,5705,4160,3490,670
Wednesday,4,2015-05-13,5752,4016,3348,668
Thursday,5,2015-05-14,5181,3605,3008,597
Friday,6,2015-05-15,4269,2913,2404,509
Saturday,7,2015-05-16,2633,1818,1473,345
Sunday,1,2015-05-17,3336,2376,1988,388
Monday,2,2015-05-18,5127,3587,2955,632
Tuesday,3,2015-05-19,5449,3767,3149,618
Wednesday,4,2015-05-20,5746,3956,3371,585
Thursday,5,2015-05-21,5115,3642,3046,596
Friday,6,2015-05-22,3995,2749,2243,506
Saturday,7,2015-05-23,2618,1884,1585,299
Sunday,1,2015-05-24,2961,2117,1763,354
Monday,2,2015-05-25,4090,2913,2427,486
Tuesday,3,2015-05-26,5201,3637,3073,564
Wednesday,4,2015-05-27,5321,3797,3146,651
Thursday,5,2015-05-28,5219,3509,2887,622
Friday,6,2015-05-29,4017,2804,2338,466
Saturday,7,2015-05-30,2297,1629,1346,283
Sunday,1,2015-05-31,3145,2226,1860,366
Monday,2,2015-06-01,4905,3419,2797,622
Tuesday,3,2015-06-02,4747,3284,2701,583
Wednesday,4,2015-06-03,4591,3317,2713,604
Thursday,5,2015-06-04,4431,3173,2652,521
Friday,6,2015-06-05,3608,2523,2068,455
Saturday,7,2015-06-06,2422,1673,1336,337
Sunday,1,2015-06-07,3132,2145,1790,355
Monday,2,2015-06-08,4962,3377,2788,589
Tuesday,3,2015-06-09,4881,3469,2862,607
Wednesday,4,2015-06-10,5001,3425,2786,639
Thursday,5,2015-06-11,4635,3242,2614,628
Friday,6,2015-06-12,3545,2494,2066,428
Saturday,7,2015-06-13,2262,1490,1235,255
Sunday,1,2015-06-14,2866,2034,1692,342
Monday,2,2015-06-15,4692,3261,2682,579
Tuesday,3,2015-06-16,4602,3204,2660,544
Wednesday,4,2015-06-17,4620,3101,2556,545
Thursday,5,2015-06-18,4475,2955,2386,569
Friday,6,2015-06-19,3564,2422,1954,468
Saturday,7,2015-06-20,2071,1370,1129,241
Sunday,1,2015-06-21,2659,1840,1523,317
Monday,2,2015-06-22,4338,2963,2410,553
Tuesday,3,2015-06-23,4531,3139,2566,573
Wednesday,4,2015-06-24,4498,3022,2481,541
Thursday,5,2015-06-25,4128,2730,2210,520
Friday,6,2015-06-26,3132,2153,1721,432
Saturday,7,2015-06-27,1829,1264,1067,197
Sunday,1,2015-06-28,2149,1517,1224,293
Monday,2,2015-06-29,3975,2691,2169,522
Tuesday,3,2015-06-30,4046,2718,2180,538
Wednesday,4,2015-07-01,3897,2745,2266,479
Thursday,5,2015-07-02,3871,2540,2072,468
Friday,6,2015-07-03,2630,1716,1353,363
Saturday,7,2015-07-04,1602,1104,900,204
Sunday,1,2015-07-05,1960,1370,1141,229
Monday,2,2015-07-06,4143,2655,2171,484
Tuesday,3,2015-07-07,4205,2789,2266,523
Wednesday,4,2015-07-08,4193,2783,2255,528
Thursday,5,2015-07-09,3710,2536,2069,467
Friday,6,2015-07-10,3137,2203,1767,436
Saturday,7,2015-07-11,1834,1145,944,201
Sunday,1,2015-07-12,2070,1473,1197,276
Monday,2,2015-07-13,4180,2852,2310,542
Tuesday,3,2015-07-14,4038,2731,2226,505
Wednesday,4,2015-07-15,3906,2667,2119,548
Thursday,5,2015-07-16,3580,2424,1940,484
Friday,6,2015-07-17,2948,2070,1708,362
Saturday,7,2015-07-18,1622,1121,924,197
Sunday,1,2015-07-19,2179,1480,1214,266
Monday,2,2015-07-20,3906,2615,2146,469
Tuesday,3,2015-07-21,3745,2596,2071,525
Wednesday,4,2015-07-22,4212,2761,2205,556
Thursday,5,2015-07-23,3901,2595,2095,500
Friday,6,2015-07-24,3292,2207,1785,422
Saturday,7,2015-07-25,1819,1229,1016,213
Sunday,1,2015-07-26,2068,1562,1286,276
Monday,2,2015-07-27,3991,2805,2243,562
Tuesday,3,2015-07-28,4073,2862,2361,501
Wednesday,4,2015-07-29,4069,2825,2324,501
Thursday,5,2015-07-30,3716,2629,2126,503
Friday,6,2015-07-31,3380,2120,1709,411
Saturday,7,2015-08-01,1737,1197,958,239
Sunday,1,2015-08-02,2181,1567,1282,285
Monday,2,2015-08-03,3973,2794,2263,531
Tuesday,3,2015-08-04,3997,2794,2269,525
Wednesday,4,2015-08-05,4132,2798,2287,511
Thursday,5,2015-08-06,3791,2693,2204,489
Friday,6,2015-08-07,2968,2139,1738,401
Saturday,7,2015-08-08,1752,1266,1021,245
Sunday,1,2015-08-09,2070,1497,1231,266
Monday,2,2015-08-10,3920,2684,2139,545
Tuesday,3,2015-08-11,4106,2791,2266,525
Wednesday,4,2015-08-12,4006,2726,2166,560
Thursday,5,2015-08-13,3827,2639,2133,506
Friday,6,2015-08-14,2944,1973,1564,409
Saturday,7,2015-08-15,1827,1193,954,239
Sunday,1,2015-08-16,2373,1658,1369,289
Monday,2,2015-08-17,4031,2763,2290,473
Tuesday,3,2015-08-18,4027,2780,2248,532
Wednesday,4,2015-08-19,3912,2795,2291,504
Thursday,5,2015-08-20,3867,2715,2191,524
Friday,6,2015-08-21,3304,2238,1806,432
Saturday,7,2015-08-22,1685,1208,1011,197
Sunday,1,2015-08-23,2130,1542,1282,260
Monday,2,2015-08-24,3936,2697,2182,515
Tuesday,3,2015-08-25,4029,2744,2203,541
Wednesday,4,2015-08-26,4010,2789,2237,552
Thursday,5,2015-08-27,4027,2890,2392,498
Friday,6,2015-08-28,2829,2000,1585,415
Saturday,7,2015-08-29,1736,1227,1023,204
Sunday,1,2015-08-30,2517,1686,1416,270
Monday,2,2015-08-31,4029,2769,2299,470
Tuesday,3,2015-09-01,4261,2890,2358,532
Wednesday,4,2015-09-02,4058,2923,2442,481
Thursday,5,2015-09-03,4392,3007,2466,541
Friday,6,2015-09-04,3072,2221,1846,375
Saturday,7,2015-09-05,1799,1284,1068,216
Sunday,1,2015-09-06,2341,1611,1345,266
Monday,2,2015-09-07,3330,2354,1963,391
Tuesday,3,2015-09-08,4734,3381,2833,548
Wednesday,4,2015-09-09,4801,3381,2845,536
Thursday,5,2015-09-10,4399,3079,2575,504
Friday,6,2015-09-11,3275,2375,1958,417
Saturday,7,2015-09-12,2042,1429,1223,206
Sunday,1,2015-09-13,2827,2103,1844,259
Monday,2,2015-09-14,4836,3437,2954,483
Tuesday,3,2015-09-15,4840,3465,2944,521
Wednesday,4,2015-09-16,4504,3356,2902,454
Thursday,5,2015-09-17,4379,3240,2736,504
Friday,6,2015-09-18,3391,2428,2024,404
Saturday,7,2015-09-19,2045,1513,1278,235
Sunday,1,2015-09-20,2721,2081,1817,264
Monday,2,2015-09-21,4630,3535,2998,537
Tuesday,3,2015-09-22,4748,3540,3004,536
Wednesday,4,2015-09-23,4702,3377,2893,484
Thursday,5,2015-09-24,4440,3309,2827,482
Friday,6,2015-09-25,3513,2518,2116,402
Saturday,7,2015-09-26,2253,1633,1395,238
Sunday,1,2015-09-27,3141,2291,1980,311
Monday,2,2015-09-28,5122,3808,3289,519
Tuesday,3,2015-09-29,5151,3868,3305,563
Wednesday,4,2015-09-30,4969,3703,3182,521
Thursday,5,2015-10-01,4619,3365,2876,489
Friday,6,2015-10-02,3443,2598,2196,402
Saturday,7,2015-10-03,2302,1754,1503,251
Sunday,1,2015-10-04,3291,2506,2173,333
Monday,2,2015-10-05,5206,3737,3170,567
Tuesday,3,2015-10-06,5474,3940,3337,603
Wednesday,4,2015-10-07,5400,3934,3350,584
Thursday,5,2015-10-08,5334,3821,3244,577
Friday,6,2015-10-09,4174,3022,2547,475
Saturday,7,2015-10-10,2571,1853,1597,256
Sunday,1,2015-10-11,3572,2636,2283,353
Monday,2,2015-10-12,5018,3788,3241,547
Tuesday,3,2015-10-13,5565,4159,3536,623
Wednesday,4,2015-10-14,5420,4048,3403,645
Thursday,5,2015-10-15,5366,3908,3331,577
Friday,6,2015-10-16,4091,3002,2507,495
Saturday,7,2015-10-17,2824,2087,1770,317
Sunday,1,2015-10-18,3843,2825,2441,384
Monday,2,2015-10-19,5516,4140,3491,649
Tuesday,3,2015-10-20,5572,4121,3460,661
Wednesday,4,2015-10-21,5243,3882,3298,584
Thursday,5,2015-10-22,5133,3720,3104,616
Friday,6,2015-10-23,4084,2947,2441,506
Saturday,7,2015-10-24,2739,1978,1647,331
Sunday,1,2015-10-25,3781,2857,2435,422
Monday,2,2015-10-26,5684,4073,3417,656
Tuesday,3,2015-10-27,5687,4179,3534,645
Wednesday,4,2015-10-28,5906,4266,3614,652
Thursday,5,2015-10-29,5541,4020,3368,652
Friday,6,2015-10-30,4171,3043,2501,542
Saturday,7,2015-10-31,2586,1820,1496,324
Sunday,1,2015-11-01,3838,2922,2456,466
Monday,2,2015-11-02,5675,4076,3419,657
Tuesday,3,2015-11-03,5624,4178,3504,674
Wednesday,4,2015-11-04,5794,4316,3670,646
Thursday,5,2015-11-05,5389,4031,3379,652
Friday,6,2015-11-06,4305,3047,2522,525
Saturday,7,2015-11-07,3281,2202,1854,348
Sunday,1,2015-11-08,3790,2837,2418,419
Monday,2,2015-11-09,5894,4203,3487,716
Tuesday,3,2015-11-10,5461,4048,3388,660
Wednesday,4,2015-11-11,5206,3869,3219,650
Thursday,5,2015-11-12,5228,3929,3281,648
Friday,6,2015-11-13,4097,2971,2436,535
Saturday,7,2015-11-14,2694,1964,1616,348
Sunday,1,2015-11-15,3893,2930,2483,447
Monday,2,2015-11-16,6185,4550,3872,678
Tuesday,3,2015-11-17,6178,4503,3795,708
Wednesday,4,2015-11-18,6067,4397,3693,704
Thursday,5,2015-11-19,5656,4166,3487,679
Friday,6,2015-11-20,4398,3173,2645,528
Saturday,7,2015-11-21,2836,2086,1741,345
Sunday,1,2015-11-22,3896,2927,2424,503
Monday,2,2015-11-23,5814,4236,3543,693
Tuesday,3,2015-11-24,5879,4140,3475,665
Wednesday,4,2015-11-25,4800,3457,2836,621
Thursday,5,2015-11-26,3838,2825,2334,491
Friday,6,2015-11-27,3576,2579,2118,461
Saturday,7,2015-11-28,2799,1974,1652,322
Sunday,1,2015-11-29,4228,3127,2605,522
Monday,2,2015-11-30,6331,4570,3817,753
Tuesday,3,2015-12-01,6380,4743,4027,716
Wednesday,4,2015-12-02,6314,4829,4039,790
Thursday,5,2015-12-03,6160,4584,3835,749
Friday,6,2015-12-04,4859,3615,2995,620
Saturday,7,2015-12-05,3317,2468,2040,428
Sunday,1,2015-12-06,4715,3550,2972,578
Monday,2,2015-12-07,6940,5136,4303,833
Tuesday,3,2015-12-08,6551,4866,4068,798
Wednesday,4,2015-12-09,6327,4761,3961,800
Thursday,5,2015-12-10,6212,4578,3830,748
Friday,6,2015-12-11,4687,3388,2771,617
Saturday,7,2015-12-12,3014,2283,1856,427
Sunday,1,2015-12-13,4132,3064,2548,516
Monday,2,2015-12-14,5989,4330,3606,724
Tuesday,3,2015-12-15,5331,3967,3309,658
Wednesday,4,2015-12-16,5183,3665,3025,640
Thursday,5,2015-12-17,4769,3515,2917,598
Friday,6,2015-12-18,3627,2518,2071,447
Saturday,7,2015-12-19,1857,1319,1087,232
Sunday,1,2015-12-20,2221,1489,1204,285
Monday,2,2015-12-21,3335,2335,1906,429
Tuesday,3,2015-12-22,2883,2047,1639,408
Wednesday,4,2015-12-23,2353,1621,1312,309
Thursday,5,2015-12-24,1578,1099,886,213
Friday,6,2015-12-25,1017,724,586,138
Saturday,7,2015-12-26,1334,936,760,176
Sunday,1,2015-12-27,1690,1155,947,208
Monday,2,2015-12-28,2838,1829,1474,355
Tuesday,3,2015-12-29,2815,1786,1419,367
Wednesday,4,2015-12-30,2382,1618,1292,326
Thursday,5,2015-12-31,1587,1035,809,226
Friday,6,2016-01-01,1411,960,786,174
Saturday,7,2016-01-02,1838,1197,969,228
Sunday,1,2016-01-03,2180,1562,1279,283
Monday,2,2016-01-04,3587,2494,2037,457
Tuesday,3,2016-01-05,3855,2742,2230,512
Wednesday,4,2016-01-06,3840,2628,2127,501
Thursday,5,2016-01-07,3735,2746,2258,488
Friday,6,2016-01-08,3223,2286,1860,426
Saturday,7,2016-01-09,2207,1531,1280,251
Sunday,1,2016-01-10,2814,2000,1661,339
Monday,2,2016-01-11,4007,2976,2444,532
Tuesday,3,2016-01-12,4119,2961,2385,576
Wednesday,4,2016-01-13,4338,3164,2631,533
Thursday,5,2016-01-14,4432,2962,2418,544
Friday,6,2016-01-15,3306,2349,1866,483
Saturday,7,2016-01-16,2223,1557,1262,295
Sunday,1,2016-01-17,2757,2002,1635,367
Monday,2,2016-01-18,4047,2898,2373,525
Tuesday,3,2016-01-19,4489,3190,2566,624
Wednesday,4,2016-01-20,4588,3232,2656,576
Thursday,5,2016-01-21,4398,3106,2561,545
Friday,6,2016-01-22,3340,2455,1990,465
Saturday,7,2016-01-23,2344,1639,1338,301
Sunday,1,2016-01-24,2973,2094,1736,358
Monday,2,2016-01-25,4638,3205,2649,556
Tuesday,3,2016-01-26,4791,3409,2834,575
Wednesday,4,2016-01-27,5104,3768,3197,571
Thursday,5,2016-01-28,4621,3439,2876,563
Friday,6,2016-01-29,3831,2715,2232,483
Saturday,7,2016-01-30,2295,1690,1400,290
Sunday,1,2016-01-31,3235,2462,2050,412
Monday,2,2016-02-01,4918,3640,3060,580
Tuesday,3,2016-02-02,5127,3783,3195,588
Wednesday,4,2016-02-03,4794,3575,2999,576
Thursday,5,2016-02-04,4788,3420,2848,572
Friday,6,2016-02-05,3948,2727,2256,471
Saturday,7,2016-02-06,2383,1765,1477,288
Sunday,1,2016-02-07,2950,2231,1839,392
Monday,2,2016-02-08,4905,3592,3024,568
Tuesday,3,2016-02-09,5353,3931,3299,632
Wednesday,4,2016-02-10,5492,4007,3358,649
Thursday,5,2016-02-11,5052,3628,3019,609
Friday,6,2016-02-12,3764,2807,2300,507
Saturday,7,2016-02-13,2458,1788,1459,329
Sunday,1,2016-02-14,3098,2277,1866,411
Monday,2,2016-02-15,4951,3652,3039,613
Tuesday,3,2016-02-16,5495,4000,3304,696
Wednesday,4,2016-02-17,5505,4062,3375,687
Thursday,5,2016-02-18,5188,3812,3156,656
Friday,6,2016-02-19,4002,2932,2377,555
Saturday,7,2016-02-20,2607,1888,1537,351
Sunday,1,2016-02-21,3906,2838,2355,483
Monday,2,2016-02-22,6360,4432,3684,748
Tuesday,3,2016-02-23,6046,4460,3714,746
Wednesday,4,2016-02-24,5938,4309,3499,810
Thursday,5,2016-02-25,5325,3892,3199,693
Friday,6,2016-02-26,4165,3048,2490,558
Saturday,7,2016-02-27,2829,2096,1726,370
Sunday,1,2016-02-28,4090,2979,2462,517
Monday,2,2016-02-29,5734,4224,3493,731
Tuesday,3,2016-03-01,6214,4474,3731,743
Wednesday,4,2016-03-02,5906,4333,3597,736
Thursday,5,2016-03-03,5814,4191,3419,772
Friday,6,2016-03-04,4507,3188,2624,564
Saturday,7,2016-03-05,2859,2064,1718,346
Sunday,1,2016-03-06,3897,2806,2326,480
Monday,2,2016-03-07,5849,4240,3503,737
Tuesday,3,2016-03-08,6264,4526,3743,783
Wednesday,4,2016-03-09,6062,4404,3624,780
Thursday,5,2016-03-10,5685,4159,3415,744
Friday,6,2016-03-11,4391,3241,2627,614
Saturday,7,2016-03-12,2880,2046,1638,408
Sunday,1,2016-03-13,3740,2673,2163,510
Monday,2,2016-03-14,5710,4261,3469,792
Tuesday,3,2016-03-15,5168,3778,3047,731
Wednesday,4,2016-03-16,5577,4062,3287,775
Thursday,5,2016-03-17,5238,3827,3134,693
Friday,6,2016-03-18,3931,2871,2320,551
Saturday,7,2016-03-19,2606,1892,1568,324
Sunday,1,2016-03-20,3149,2410,2028,382
Monday,2,2016-03-21,5565,3968,3274,694
Tuesday,3,2016-03-22,5281,3770,3035,735
Wednesday,4,2016-03-23,5202,3780,3146,634
Thursday,5,2016-03-24,4581,3203,2649,554
Friday,6,2016-03-25,3264,2281,1847,434
Saturday,7,2016-03-26,2344,1759,1393,366
Sunday,1,2016-03-27,3112,2311,1890,421
Monday,2,2016-03-28,5051,3655,2985,670
Tuesday,3,2016-03-29,5333,3944,3217,727
Wednesday,4,2016-03-30,5671,4078,3369,709
Thursday,5,2016-03-31,5097,3707,3026,681
Friday,6,2016-04-01,4555,2971,2408,563
Saturday,7,2016-04-02,2987,2129,1737,392
Sunday,1,2016-04-03,4257,2964,2421,543
Monday,2,2016-04-04,5804,4216,3426,790
Tuesday,3,2016-04-05,5885,4379,3597,782
Wednesday,4,2016-04-06,6054,4293,3522,771
Thursday,5,2016-04-07,5791,4147,3422,725
Friday,6,2016-04-08,4741,3430,2820,610
Saturday,7,2016-04-09,2946,2140,1740,400
Sunday,1,2016-04-10,4071,2864,2330,534
Monday,2,2016-04-11,6265,4503,3667,836
Tuesday,3,2016-04-12,6298,4626,3769,857
Wednesday,4,2016-04-13,6495,4628,3791,837
Thursday,5,2016-04-14,5536,4189,3431,758
Friday,6,2016-04-15,4737,3447,2785,662
Saturday,7,2016-04-16,3232,2333,1862,471
Sunday,1,2016-04-17,4201,3093,2504,589
Monday,2,2016-04-18,6806,4769,3920,849
Tuesday,3,2016-04-19,6769,4817,3940,877
Wednesday,4,2016-04-20,6581,4824,3926,898
Thursday,5,2016-04-21,6254,4537,3707,830
Friday,6,2016-04-22,5163,3685,3009,676
Saturday,7,2016-04-23,3851,2595,2113,482
Sunday,1,2016-04-24,4695,3386,2761,625
Monday,2,2016-04-25,7098,5224,4237,987
Tuesday,3,2016-04-26,7156,5392,4468,924
Wednesday,4,2016-04-27,6836,5056,4130,926
Thursday,5,2016-04-28,6329,4724,3892,832
Friday,6,2016-04-29,4990,3608,2922,686
Saturday,7,2016-04-30,3536,2489,1993,496
Sunday,1,2016-05-01,4366,3236,2605,631
Monday,2,2016-05-02,6510,4786,3909,877
Tuesday,3,2016-05-03,6855,4962,4085,877
Wednesday,4,2016-05-04,6599,4651,3744,907
Thursday,5,2016-05-05,5510,4105,3375,730
Friday,6,2016-05-06,4549,3245,2639,606
Saturday,7,2016-05-07,3064,2167,1760,407
Sunday,1,2016-05-08,3633,2663,2180,483
Monday,2,2016-05-09,5838,4283,3489,794
Tuesday,3,2016-05-10,6026,4336,3581,755
Wednesday,4,2016-05-11,5780,4226,3479,747
Thursday,5,2016-05-12,5131,3781,3101,680
Friday,6,2016-05-13,3928,2845,2294,551
Saturday,7,2016-05-14,2636,1930,1552,378
Sunday,1,2016-05-15,3278,2366,1922,444
Monday,2,2016-05-16,4785,3560,2882,678
Tuesday,3,2016-05-17,4886,3601,2914,687
Wednesday,4,2016-05-18,5145,3672,2987,685
Thursday,5,2016-05-19,5849,4211,3484,727
Friday,6,2016-05-20,4456,3324,2725,599
Saturday,7,2016-05-21,2960,2138,1716,422
Sunday,1,2016-05-22,3885,2860,2338,522
Monday,2,2016-05-23,5857,4155,3368,787
Tuesday,3,2016-05-24,6162,4345,3526,819
Wednesday,4,2016-05-25,6014,4254,3398,856
Thursday,5,2016-05-26,5652,4119,3385,734
Friday,6,2016-05-27,4793,3340,2692,648
Saturday,7,2016-05-28,2819,1995,1611,384
Sunday,1,2016-05-29,3687,2546,2067,479
Monday,2,2016-05-30,4851,3399,2701,698
Tuesday,3,2016-05-31,5775,4216,3413,803
Wednesday,4,2016-06-01,5443,3962,3193,769
Thursday,5,2016-06-02,5590,3959,3176,783
Friday,6,2016-06-03,4482,3164,2489,675
Saturday,7,2016-06-04,2792,1947,1533,414
Sunday,1,2016-06-05,3371,2449,1979,470
Monday,2,2016-06-06,5547,3832,3036,796
Tuesday,3,2016-06-07,5468,3954,3226,728
Wednesday,4,2016-06-08,5104,3751,3064,687
Thursday,5,2016-06-09,4728,3485,2812,673
Friday,6,2016-06-10,4024,2855,2290,565
Saturday,7,2016-06-11,2350,1677,1348,329
Sunday,1,2016-06-12,3234,2196,1779,417
Monday,2,2016-06-13,4948,3550,2790,760
Tuesday,3,2016-06-14,5247,3760,3052,708
Wednesday,4,2016-06-15,5003,3557,2810,747
Thursday,5,2016-06-16,4816,3482,2775,707
Friday,6,2016-06-17,4208,2818,2267,551
Saturday,7,2016-06-18,2454,1668,1357,311
Sunday,1,2016-06-19,2763,1919,1506,413
Monday,2,2016-06-20,4954,3522,2829,693
Tuesday,3,2016-06-21,4903,3470,2793,677
Wednesday,4,2016-06-22,4907,3464,2772,692
Thursday,5,2016-06-23,4625,3336,2669,667
Friday,6,2016-06-24,3497,2482,1947,535
Saturday,7,2016-06-25,1826,1358,1101,257
Sunday,1,2016-06-26,2307,1721,1356,365
Monday,2,2016-06-27,4368,3078,2433,645
Tuesday,3,2016-06-28,4233,3091,2466,625
Wednesday,4,2016-06-29,4187,2948,2377,571
Thursday,5,2016-06-30,3811,2726,2135,591
Friday,6,2016-07-01,3179,2226,1730,496
Saturday,7,2016-07-02,1615,1039,814,225
Sunday,1,2016-07-03,1788,1307,1028,279
Monday,2,2016-07-04,2959,2144,1653,491
Tuesday,3,2016-07-05,3947,2840,2235,605
Wednesday,4,2016-07-06,3841,2821,2248,573
Thursday,5,2016-07-07,3729,2700,2148,552
Friday,6,2016-07-08,3324,2381,1891,490
Saturday,7,2016-07-09,1795,1305,1036,269
Sunday,1,2016-07-10,2373,1655,1321,334
Monday,2,2016-07-11,4101,2855,2208,647
Tuesday,3,2016-07-12,4241,2960,2352,608
Wednesday,4,2016-07-13,4478,3189,2578,611
Thursday,5,2016-07-14,3961,2814,2214,600
Friday,6,2016-07-15,3367,2325,1796,529
Saturday,7,2016-07-16,1828,1222,951,271
Sunday,1,2016-07-17,2344,1636,1319,317
Monday,2,2016-07-18,4415,3007,2382,625
Tuesday,3,2016-07-19,4403,3151,2502,649
Wednesday,4,2016-07-20,4244,3082,2450,632
Thursday,5,2016-07-21,4322,3077,2404,673
Friday,6,2016-07-22,3456,2431,1936,495
Saturday,7,2016-07-23,2068,1407,1099,308
Sunday,1,2016-07-24,2568,1755,1374,381
Monday,2,2016-07-25,4770,3320,2628,692
Tuesday,3,2016-07-26,4621,3277,2595,682
Wednesday,4,2016-07-27,4470,3164,2513,651
Thursday,5,2016-07-28,4307,3077,2459,618
Friday,6,2016-07-29,3370,2366,1818,548
Saturday,7,2016-07-30,1960,1341,1017,324
Sunday,1,2016-07-31,2412,1765,1423,342
Monday,2,2016-08-01,4504,3095,2489,606
Tuesday,3,2016-08-02,4382,3138,2499,639
Wednesday,4,2016-08-03,4710,3369,2697,672
Thursday,5,2016-08-04,4324,3106,2479,627
Friday,6,2016-08-05,3472,2497,1980,517
Saturday,7,2016-08-06,1909,1339,1081,258
Sunday,1,2016-08-07,2365,1688,1334,354
Monday,2,2016-08-08,4460,3056,2438,618
Tuesday,3,2016-08-09,4479,3135,2482,653
Wednesday,4,2016-08-10,4510,3207,2550,657
Thursday,5,2016-08-11,4340,3111,2491,620
Friday,6,2016-08-12,3508,2436,1933,503
Saturday,7,2016-08-13,2030,1420,1122,298
Sunday,1,2016-08-14,2586,1749,1399,350
Monday,2,2016-08-15,4476,2970,2346,624
Tuesday,3,2016-08-16,3232,2299,1823,476
Wednesday,4,2016-08-17,4291,3106,2498,608
Thursday,5,2016-08-18,4247,2926,2327,599
Friday,6,2016-08-19,3477,2539,2045,494
Saturday,7,2016-08-20,2169,1470,1169,301
Sunday,1,2016-08-21,2430,1808,1453,355
Monday,2,2016-08-22,4358,3082,2439,643
Tuesday,3,2016-08-23,4465,3249,2550,699
Wednesday,4,2016-08-24,4550,3210,2615,595
Thursday,5,2016-08-25,4147,3011,2380,631
Friday,6,2016-08-26,3634,2532,2000,532
Saturday,7,2016-08-27,2014,1430,1141,289
Sunday,1,2016-08-28,2687,1910,1555,355
Monday,2,2016-08-29,4376,3115,2521,594
Tuesday,3,2016-08-30,4318,3226,2622,604
Wednesday,4,2016-08-31,4441,3219,2620,599
Thursday,5,2016-09-01,4234,3116,2556,560
Friday,6,2016-09-02,3027,2230,1762,468
Saturday,7,2016-09-03,1966,1376,1101,275
Sunday,1,2016-09-04,2446,1761,1452,309
Monday,2,2016-09-05,3779,2643,2145,498
Tuesday,3,2016-09-06,4619,3341,2727,614
Wednesday,4,2016-09-07,4983,3584,2925,659
Thursday,5,2016-09-08,4645,3319,2716,603
Friday,6,2016-09-09,3612,2630,2139,491
Saturday,7,2016-09-10,2153,1577,1323,254
Sunday,1,2016-09-11,3089,2307,1978,329
Monday,2,2016-09-12,4580,3446,2882,564
Tuesday,3,2016-09-13,4788,3625,2992,633
Wednesday,4,2016-09-14,5095,3759,3113,646
Thursday,5,2016-09-15,4668,3454,2860,594
Friday,6,2016-09-16,3711,2785,2272,513
Saturday,7,2016-09-17,2523,1861,1577,284
Sunday,1,2016-09-18,3364,2547,2122,425
Monday,2,2016-09-19,5513,4050,3321,729
Tuesday,3,2016-09-20,5362,3762,3095,667
Wednesday,4,2016-09-21,5402,3987,3293,694
Thursday,5,2016-09-22,5398,3996,3299,697
Friday,6,2016-09-23,3783,2663,2134,529
Saturday,7,2016-09-24,2395,1797,1503,294
Sunday,1,2016-09-25,3679,2719,2289,430
Monday,2,2016-09-26,5688,4325,3570,755
Tuesday,3,2016-09-27,5842,4382,3645,737
Wednesday,4,2016-09-28,5923,4458,3682,776
Thursday,5,2016-09-29,5717,4222,3487,735
Friday,6,2016-09-30,4250,3176,2565,611
Saturday,7,2016-10-01,2525,1986,1656,330
Sunday,1,2016-10-02,3923,3023,2559,464
Monday,2,2016-10-03,5785,4281,3545,736
Tuesday,3,2016-10-04,6052,4522,3780,742
Wednesday,4,2016-10-05,6150,4588,3814,774
Thursday,5,2016-10-06,5591,4134,3419,715
Friday,6,2016-10-07,4279,3196,2616,580
Saturday,7,2016-10-08,2897,2066,1717,349
Sunday,1,2016-10-09,3904,2873,2374,499
Monday,2,2016-10-10,5458,4145,3442,703
Tuesday,3,2016-10-11,5909,4399,3685,714
Wednesday,4,2016-10-12,6175,4620,3823,797
Thursday,5,2016-10-13,5856,4422,3581,841
Friday,6,2016-10-14,4610,3505,2837,668
Saturday,7,2016-10-15,3081,2269,1864,405
Sunday,1,2016-10-16,4390,3265,2718,547
Monday,2,2016-10-17,6507,4917,4018,899
Tuesday,3,2016-10-18,6941,5103,4189,914
Wednesday,4,2016-10-19,6576,4776,3961,815
Thursday,5,2016-10-20,5985,4462,3701,761
Friday,6,2016-10-21,4789,3497,2840,657
Saturday,7,2016-10-22,3263,2292,1881,411
Sunday,1,2016-10-23,4180,3135,2561,574
Monday,2,2016-10-24,6371,4865,3993,872
Tuesday,3,2016-10-25,6648,4960,4070,890
Wednesday,4,2016-10-26,6501,4777,3880,897
Thursday,5,2016-10-27,6088,4431,3574,857
Friday,6,2016-10-28,4376,3179,2510,669
Saturday,7,2016-10-29,2733,1955,1549,406
Sunday,1,2016-10-30,3953,2921,2344,577
Monday,2,2016-10-31,6108,4416,3563,853
Tuesday,3,2016-11-01,5668,4185,3360,825
Wednesday,4,2016-11-02,6159,4508,3663,845
Thursday,5,2016-11-03,5810,4241,3426,815
Friday,6,2016-11-04,4491,3394,2670,724
Saturday,7,2016-11-05,3110,2263,1842,421
Sunday,1,2016-11-06,4418,3281,2713,568
Monday,2,2016-11-07,6529,4488,3573,915
Tuesday,3,2016-11-08,5756,4251,3437,814
Wednesday,4,2016-11-09,5716,4102,3315,787
Thursday,5,2016-11-10,5323,4022,3246,776
Friday,6,2016-11-11,4280,3085,2441,644
Saturday,7,2016-11-12,2982,2169,1777,392
Sunday,1,2016-11-13,4365,3172,2595,577
Monday,2,2016-11-14,6627,4888,3942,946
Tuesday,3,2016-11-15,6467,4808,3905,903
Wednesday,4,2016-11-16,6631,4903,3984,919
Thursday,5,2016-11-17,6378,4681,3779,902
Friday,6,2016-11-18,4767,3424,2734,690
Saturday,7,2016-11-19,3501,2580,2136,444
Sunday,1,2016-11-20,4647,3426,2777,649
Monday,2,2016-11-21,6336,4693,3788,905
Tuesday,3,2016-11-22,6222,4564,3646,918
Wednesday,4,2016-11-23,5527,3904,3082,822
Thursday,5,2016-11-24,4267,3197,2561,636
Friday,6,2016-11-25,3733,2678,2135,543
Saturday,7,2016-11-26,3299,2394,1907,487
Sunday,1,2016-11-27,4530,3396,2722,674
Monday,2,2016-11-28,6908,5047,4167,880
Tuesday,3,2016-11-29,7714,5338,4369,969
Wednesday,4,2016-11-30,7490,5425,4389,1036
Thursday,5,2016-12-01,7190,5081,4120,961
Friday,6,2016-12-02,5391,3977,3171,806
Saturday,7,2016-12-03,3575,2667,2178,489
Sunday,1,2016-12-04,5285,4031,3247,784
Monday,2,2016-12-05,7330,5439,4452,987
Tuesday,3,2016-12-06,7489,5479,4500,979
Wednesday,4,2016-12-07,7345,5467,4469,998
Thursday,5,2016-12-08,6679,4991,3998,993
Friday,6,2016-12-09,5403,3970,3190,780
Saturday,7,2016-12-10,3573,2712,2203,509
Sunday,1,2016-12-11,4834,3515,2838,677
Monday,2,2016-12-12,6905,4945,3988,957
Tuesday,3,2016-12-13,6743,4927,3942,985
Wednesday,4,2016-12-14,6201,4488,3593,895
Thursday,5,2016-12-15,5571,4071,3229,842
Friday,6,2016-12-16,3872,2780,2191,589
Saturday,7,2016-12-17,2613,1884,1480,404
Sunday,1,2016-12-18,3109,2293,1853,440
Monday,2,2016-12-19,4324,3145,2477,668
Tuesday,3,2016-12-20,4226,3064,2339,725
Wednesday,4,2016-12-21,3991,2914,2278,636
Thursday,5,2016-12-22,3160,2211,1728,483
Friday,6,2016-12-23,2386,1626,1257,369
Saturday,7,2016-12-24,1115,825,634,191
Sunday,1,2016-12-25,1387,930,740,190
Monday,2,2016-12-26,2147,1418,1142,276
Tuesday,3,2016-12-27,2686,1777,1349,428
Wednesday,4,2016-12-28,2885,1915,1476,439
Thursday,5,2016-12-29,2694,1837,1400,437
Friday,6,2016-12-30,2273,1541,1164,377
Saturday,7,2016-12-31,1188,836,643,193
Sunday,1,2017-01-01,1447,1039,832,207
Monday,2,2017-01-02,2568,1844,1448,396
Tuesday,3,2017-01-03,3566,2527,1970,557
Wednesday,4,2017-01-04,3941,2816,2226,590
Thursday,5,2017-01-05,3841,2625,2058,567
Friday,6,2017-01-06,3261,2338,1812,526
Saturday,7,2017-01-07,2241,1523,1204,319
Sunday,1,2017-01-08,2679,1892,1519,373
Monday,2,2017-01-09,4182,2841,2191,650
Tuesday,3,2017-01-10,4236,3039,2391,648
Wednesday,4,2017-01-11,4628,3206,2536,670
Thursday,5,2017-01-12,4205,3025,2403,622
Friday,6,2017-01-13,3459,2508,2033,475
Saturday,7,2017-01-14,2448,1744,1390,354
Sunday,1,2017-01-15,2853,2015,1586,429
Monday,2,2017-01-16,4638,3178,2543,635
Tuesday,3,2017-01-17,5325,3669,2942,727
Wednesday,4,2017-01-18,4866,3364,2670,694
Thursday,5,2017-01-19,4715,3375,2689,686
Friday,6,2017-01-20,3753,2713,2136,577
Saturday,7,2017-01-21,2481,1778,1437,341
Sunday,1,2017-01-22,3233,2401,1981,420
Monday,2,2017-01-23,5034,3660,2957,703
Tuesday,3,2017-01-24,4787,3593,2909,684
Wednesday,4,2017-01-25,4901,3602,2923,679
Thursday,5,2017-01-26,4398,3266,2653,613
Friday,6,2017-01-27,3823,2832,2267,565
Saturday,7,2017-01-28,2619,1901,1534,367
Sunday,1,2017-01-29,3518,2612,2205,407
Monday,2,2017-01-30,5178,3826,3127,699
Tuesday,3,2017-01-31,5290,3876,3127,749
Wednesday,4,2017-02-01,5469,4116,3402,714
Thursday,5,2017-02-02,5399,4028,3303,725
Friday,6,2017-02-03,4232,3012,2342,670
Saturday,7,2017-02-04,2828,2084,1697,387
Sunday,1,2017-02-05,3724,2783,2281,502
Monday,2,2017-02-06,5733,4249,3448,801
Tuesday,3,2017-02-07,5814,4284,3521,763
Wednesday,4,2017-02-08,5349,4006,3248,758
Thursday,5,2017-02-09,5025,3681,3010,671
Friday,6,2017-02-10,4044,2922,2335,587
Saturday,7,2017-02-11,2323,1731,1377,354
Sunday,1,2017-02-12,3147,2469,2005,464
Monday,2,2017-02-13,4972,3719,3014,705
Tuesday,3,2017-02-14,4878,3582,2897,685
Wednesday,4,2017-02-15,5288,3786,3039,747
Thursday,5,2017-02-16,4968,3668,2934,734
Friday,6,2017-02-17,3788,2748,2158,590
Saturday,7,2017-02-18,2514,1839,1496,343
Sunday,1,2017-02-19,3463,2602,2083,519
Monday,2,2017-02-20,4931,3700,3009,691
Tuesday,3,2017-02-21,5101,3873,3079,794
Wednesday,4,2017-02-22,5144,3727,2998,729
Thursday,5,2017-02-23,4433,3372,2657,715
Friday,6,2017-02-24,3597,2648,2111,537
Saturday,7,2017-02-25,2621,1826,1482,344
Sunday,1,2017-02-26,3397,2494,2021,473
Monday,2,2017-02-27,5062,3812,3009,803
Tuesday,3,2017-02-28,4926,3678,2933,745
Wednesday,4,2017-03-01,4936,3558,2822,736
Thursday,5,2017-03-02,4688,3441,2747,694
Friday,6,2017-03-03,3827,2699,2140,559
Saturday,7,2017-03-04,2452,1754,1408,346
Sunday,1,2017-03-05,3283,2394,1958,436
Monday,2,2017-03-06,4823,3481,2764,717
Tuesday,3,2017-03-07,4821,3662,2942,720
Wednesday,4,2017-03-08,5059,3613,2923,690
Thursday,5,2017-03-09,4585,3444,2744,700
Friday,6,2017-03-10,3682,2733,2178,555
Saturday,7,2017-03-11,2350,1714,1351,363
Sunday,1,2017-03-12,3056,2189,1755,434
Monday,2,2017-03-13,4746,3367,2721,646
Tuesday,3,2017-03-14,4613,3465,2808,657
Wednesday,4,2017-03-15,4560,3441,2694,747
Thursday,5,2017-03-16,4520,3304,2629,675
Friday,6,2017-03-17,3346,2433,1930,503
Saturday,7,2017-03-18,2253,1649,1325,324
Sunday,1,2017-03-19,2927,2267,1807,460
Monday,2,2017-03-20,4878,3463,2799,664
Tuesday,3,2017-03-21,4852,3481,2802,679
Wednesday,4,2017-03-22,4585,3430,2757,673
Thursday,5,2017-03-23,4477,3260,2600,660
Friday,6,2017-03-24,3654,2566,1993,573
Saturday,7,2017-03-25,2411,1760,1420,340
Sunday,1,2017-03-26,3054,2336,1882,454
Monday,2,2017-03-27,4696,3479,2765,714
Tuesday,3,2017-03-28,5033,3633,2875,758
Wednesday,4,2017-03-29,4948,3530,2809,721
Thursday,5,2017-03-30,4636,3390,2704,686
Friday,6,2017-03-31,3539,2636,2060,576
Saturday,7,2017-04-01,2371,1678,1338,340
Sunday,1,2017-04-02,2816,2159,1715,444
Monday,2,2017-04-03,4493,3356,2672,684
Tuesday,3,2017-04-04,4678,3486,2739,747
Wednesday,4,2017-04-05,4737,3484,2762,722
Thursday,5,2017-04-06,4775,3514,2806,708
Friday,6,2017-04-07,3658,2725,2181,544
Saturday,7,2017-04-08,2260,1664,1324,340
Sunday,1,2017-04-09,3343,2433,1933,500
Monday,2,2017-04-10,4640,3440,2756,684
Tuesday,3,2017-04-11,4694,3532,2867,665
Wednesday,4,2017-04-12,4771,3517,2800,717
Thursday,5,2017-04-13,4173,3017,2395,622
Friday,6,2017-04-14,3046,2238,1752,486
Saturday,7,2017-04-15,2260,1701,1333,368
Sunday,1,2017-04-16,2876,2143,1700,443
Monday,2,2017-04-17,4774,3402,2719,683
Tuesday,3,2017-04-18,5009,3702,2906,796
Wednesday,4,2017-04-19,5369,3852,3133,719
Thursday,5,2017-04-20,5020,3669,2969,700
Friday,6,2017-04-21,3935,2802,2203,599
Saturday,7,2017-04-22,2795,2049,1630,419
Sunday,1,2017-04-23,3795,2827,2305,522
Monday,2,2017-04-24,5489,4083,3252,831
Tuesday,3,2017-04-25,5680,4108,3336,772
Wednesday,4,2017-04-26,5383,3940,3205,735
Thursday,5,2017-04-27,4890,3695,2985,710
Friday,6,2017-04-28,3872,2887,2310,577
Saturday,7,2017-04-29,2790,1987,1602,385
Sunday,1,2017-04-30,3524,2616,2118,498
Monday,2,2017-05-01,4903,3551,2875,676
Tuesday,3,2017-05-02,5160,3802,3079,723
Wednesday,4,2017-05-03,5194,3766,2995,771
Thursday,5,2017-05-04,5142,3755,3013,742
Friday,6,2017-05-05,3836,2925,2323,602
Saturday,7,2017-05-06,2737,1981,1572,409
Sunday,1,2017-05-07,3386,2534,2025,509
Monday,2,2017-05-08,4816,3585,2900,685
Tuesday,3,2017-05-09,4734,3458,2763,695
Wednesday,4,2017-05-10,4761,3475,2754,721
Thursday,5,2017-05-11,4277,3224,2570,654
Friday,6,2017-05-12,3563,2620,2056,564
Saturday,7,2017-05-13,2401,1749,1379,370
Sunday,1,2017-05-14,2877,2126,1674,452
Monday,2,2017-05-15,4448,3191,2494,697
Tuesday,3,2017-05-16,4525,3226,2593,633
Wednesday,4,2017-05-17,4533,3318,2676,642
Thursday,5,2017-05-18,4431,3307,2686,621
Friday,6,2017-05-19,3456,2470,1938,532
Saturday,7,2017-05-20,2162,1651,1332,319
Sunday,1,2017-05-21,2786,1971,1597,374
Monday,2,2017-05-22,4172,3041,2403,638
Tuesday,3,2017-05-23,4255,3077,2457,620
Wednesday,4,2017-05-24,4154,2996,2400,596
Thursday,5,2017-05-25,3803,2839,2263,576
Friday,6,2017-05-26,2950,2183,1720,463
Saturday,7,2017-05-27,1909,1444,1155,289
Sunday,1,2017-05-28,2506,1781,1399,382
Monday,2,2017-05-29,3325,2457,1913,544
Tuesday,3,2017-05-30,4086,2909,2298,611
Wednesday,4,2017-05-31,3716,2667,2069,598
Thursday,5,2017-06-01,3702,2639,2103,536
Friday,6,2017-06-02,2959,2171,1680,491
Saturday,7,2017-06-03,2006,1471,1161,310
Sunday,1,2017-06-04,2479,1795,1419,376
Monday,2,2017-06-05,3501,2610,2072,538
Tuesday,3,2017-06-06,3985,2922,2361,561
Wednesday,4,2017-06-07,3920,2913,2314,599
Thursday,5,2017-06-08,3868,2796,2209,587
Friday,6,2017-06-09,2921,2101,1660,441
Saturday,7,2017-06-10,1655,1244,975,269
Sunday,1,2017-06-11,2229,1622,1299,323
Monday,2,2017-06-12,3660,2598,2020,578
Tuesday,3,2017-06-13,3898,2809,2202,607
Wednesday,4,2017-06-14,3912,2797,2200,597
Thursday,5,2017-06-15,3604,2624,2029,595
Friday,6,2017-06-16,2970,2105,1621,484
Saturday,7,2017-06-17,1546,1187,957,230
Sunday,1,2017-06-18,1944,1465,1146,319
Monday,2,2017-06-19,3608,2493,1959,534
Tuesday,3,2017-06-20,3514,2472,1905,567
Wednesday,4,2017-06-21,3344,2475,1915,560
Thursday,5,2017-06-22,3292,2351,1824,527
Friday,6,2017-06-23,2469,1850,1445,405
Saturday,7,2017-06-24,1296,925,702,223
Sunday,1,2017-06-25,1546,1071,811,260
Monday,2,2017-06-26,2948,1998,1528,470
Tuesday,3,2017-06-27,3077,2190,1690,500
Wednesday,4,2017-06-28,3028,2145,1649,496
Thursday,5,2017-06-29,2738,1976,1474,502
Friday,6,2017-06-30,2147,1478,1087,391
Saturday,7,2017-07-01,1277,903,675,228
Sunday,1,2017-07-02,1606,1142,879,263
Monday,2,2017-07-03,2504,1726,1296,430
Tuesday,3,2017-07-04,2218,1566,1217,349
Wednesday,4,2017-07-05,3024,2149,1681,468
Thursday,5,2017-07-06,2951,2047,1555,492
Friday,6,2017-07-07,2401,1693,1310,383
Saturday,7,2017-07-08,1242,891,700,191
Sunday,1,2017-07-09,1511,1172,938,234
Monday,2,2017-07-10,2934,2062,1619,443
Tuesday,3,2017-07-11,3003,2140,1663,477
Wednesday,4,2017-07-12,3073,2192,1710,482
Thursday,5,2017-07-13,2933,2043,1550,493
Friday,6,2017-07-14,2468,1710,1287,423
Saturday,7,2017-07-15,1355,892,689,203
Sunday,1,2017-07-16,1553,1122,891,231
Monday,2,2017-07-17,2902,1954,1479,475
Tuesday,3,2017-07-18,2899,2109,1591,518
Wednesday,4,2017-07-19,2986,2032,1584,448
Thursday,5,2017-07-20,2964,2031,1571,460
Friday,6,2017-07-21,2433,1609,1214,395
Saturday,7,2017-07-22,1280,923,725,198
Sunday,1,2017-07-23,1603,1170,909,261
Monday,2,2017-07-24,3154,2214,1726,488
Tuesday,3,2017-07-25,3084,2148,1666,482
Wednesday,4,2017-07-26,2983,1925,1490,435
Thursday,5,2017-07-27,2849,1908,1440,468
Friday,6,2017-07-28,2420,1538,1150,388
Saturday,7,2017-07-29,1300,895,712,183
Sunday,1,2017-07-30,1526,1112,863,249
Monday,2,2017-07-31,2872,1978,1481,497
Tuesday,3,2017-08-01,2914,1957,1463,494
Wednesday,4,2017-08-02,2843,1994,1536,458
Thursday,5,2017-08-03,2649,1894,1447,447
Friday,6,2017-08-04,2042,1478,1150,328
Saturday,7,2017-08-05,1225,901,681,220
Sunday,1,2017-08-06,1562,1045,792,253
Monday,2,2017-08-07,2751,1823,1398,425
Tuesday,3,2017-08-08,2634,1868,1415,453
Wednesday,4,2017-08-09,2704,1961,1511,450
Thursday,5,2017-08-10,2670,1864,1463,401
Friday,6,2017-08-11,2073,1498,1121,377
Saturday,7,2017-08-12,1240,888,669,219
Sunday,1,2017-08-13,1530,1076,811,265
Monday,2,2017-08-14,2392,1704,1346,358
Tuesday,3,2017-08-15,2675,1846,1471,375
Wednesday,4,2017-08-16,2755,1911,1436,475
Thursday,5,2017-08-17,2608,1824,1421,403
Friday,6,2017-08-18,2163,1521,1163,358
Saturday,7,2017-08-19,1304,951,743,208
Sunday,1,2017-08-20,1969,1419,1156,263
Monday,2,2017-08-21,2985,2069,1575,494
Tuesday,3,2017-08-22,3087,2259,1772,487
Wednesday,4,2017-08-23,3047,2147,1704,443
Thursday,5,2017-08-24,2961,2026,1600,426
Friday,6,2017-08-25,2293,1589,1257,332
Saturday,7,2017-08-26,1261,934,751,183
Sunday,1,2017-08-27,1676,1211,983,228
Monday,2,2017-08-28,1786,1287,1005,282
Tuesday,3,2017-08-29,3252,2310,1845,465
Wednesday,4,2017-08-30,3082,2179,1741,438
Thursday,5,2017-08-31,2721,1963,1579,384
Friday,6,2017-09-01,2217,1583,1235,348
Saturday,7,2017-09-02,1271,908,730,178
Sunday,1,2017-09-03,1742,1197,958,239
Monday,2,2017-09-04,2293,1704,1380,324
Tuesday,3,2017-09-05,3155,2289,1818,471
Wednesday,4,2017-09-06,3159,2320,1882,438
Thursday,5,2017-09-07,3054,2243,1777,466
Friday,6,2017-09-08,2440,1848,1488,360
Saturday,7,2017-09-09,1532,1108,924,184
Sunday,1,2017-09-10,2247,1657,1366,291
Monday,2,2017-09-11,3570,2496,2033,463
Tuesday,3,2017-09-12,3524,2540,2075,465
Wednesday,4,2017-09-13,3471,2473,2040,433
Thursday,5,2017-09-14,3303,2415,1974,441
Friday,6,2017-09-15,2560,1867,1519,348
Saturday,7,2017-09-16,1470,1090,912,178
Sunday,1,2017-09-17,2234,1715,1446,269
Monday,2,2017-09-18,3504,2596,2123,473
Tuesday,3,2017-09-19,3984,2840,2382,458
Wednesday,4,2017-09-20,3746,2660,2188,472
Thursday,5,2017-09-21,3524,2667,2143,524
Friday,6,2017-09-22,2639,1944,1591,353
Saturday,7,2017-09-23,1523,1178,975,203
Sunday,1,2017-09-24,2425,1809,1521,288
Monday,2,2017-09-25,3671,2705,2202,503
Tuesday,3,2017-09-26,3669,2780,2306,474
Wednesday,4,2017-09-27,3537,2657,2211,446
Thursday,5,2017-09-28,3413,2507,2048,459
Friday,6,2017-09-29,2699,1902,1554,348
Saturday,7,2017-09-30,1829,1289,1058,231
Sunday,1,2017-10-01,2379,1812,1507,305
Monday,2,2017-10-02,3637,2669,2221,448
Tuesday,3,2017-10-03,3775,2787,2253,534
Wednesday,4,2017-10-04,3572,2731,2245,486
Thursday,5,2017-10-05,3605,2695,2230,465
Friday,6,2017-10-06,2774,2078,1670,408
Saturday,7,2017-10-07,1780,1354,1106,248
Sunday,1,2017-10-08,2469,1884,1571,313
Monday,2,2017-10-09,3881,2869,2348,521
Tuesday,3,2017-10-10,3767,2785,2296,489
Wednesday,4,2017-10-11,4082,2924,2335,589
Thursday,5,2017-10-12,4047,2768,2240,528
Friday,6,2017-10-13,2877,2114,1706,408
Saturday,7,2017-10-14,2073,1559,1298,261
Sunday,1,2017-10-15,2759,2066,1739,327
Monday,2,2017-10-16,3817,2880,2344,536
Tuesday,3,2017-10-17,3949,2930,2402,528
Wednesday,4,2017-10-18,3867,2896,2395,501
Thursday,5,2017-10-19,3621,2582,2119,463
Friday,6,2017-10-20,2978,2220,1772,448
Saturday,7,2017-10-21,1992,1434,1158,276
Sunday,1,2017-10-22,2851,2142,1779,363
Monday,2,2017-10-23,4390,3177,2651,526
Tuesday,3,2017-10-24,3886,2938,2406,532
Wednesday,4,2017-10-25,3424,2477,2017,460
Thursday,5,2017-10-26,4207,3087,2561,526
Friday,6,2017-10-27,3345,2478,1984,494
Saturday,7,2017-10-28,2128,1567,1277,290
Sunday,1,2017-10-29,2205,1637,1319,318
Monday,2,2017-10-30,4091,2999,2453,546
Tuesday,3,2017-10-31,4223,3143,2555,588
Wednesday,4,2017-11-01,4361,3147,2554,593
Thursday,5,2017-11-02,4263,3103,2513,590
Friday,6,2017-11-03,3341,2397,1903,494
Saturday,7,2017-11-04,2278,1634,1307,327
Sunday,1,2017-11-05,3097,2299,1888,411
Monday,2,2017-11-06,4185,3113,2538,575
Tuesday,3,2017-11-07,4477,3341,2689,652
Wednesday,4,2017-11-08,4354,3227,2579,648
Thursday,5,2017-11-09,4194,3005,2401,604
Friday,6,2017-11-10,3240,2319,1833,486
Saturday,7,2017-11-11,2424,1613,1283,330
Sunday,1,2017-11-12,3168,2309,1853,456
Monday,2,2017-11-13,4709,3433,2784,649
Tuesday,3,2017-11-14,4634,3373,2727,646
Wednesday,4,2017-11-15,4545,3345,2681,664
Thursday,5,2017-11-16,4532,3332,2693,639
Friday,6,2017-11-17,3317,2508,2018,490
Saturday,7,2017-11-18,2449,1741,1386,355
Sunday,1,2017-11-19,2893,2231,1780,451
Monday,2,2017-11-20,4170,3135,2555,580
Tuesday,3,2017-11-21,4277,3026,2419,607
Wednesday,4,2017-11-22,3588,2625,2078,547
Thursday,5,2017-11-23,3141,2237,1760,477
Friday,6,2017-11-24,2658,1843,1429,414
Saturday,7,2017-11-25,2391,1652,1327,325
Sunday,1,2017-11-26,3202,2354,1901,453
Monday,2,2017-11-27,4349,3251,2601,650
Tuesday,3,2017-11-28,4886,3660,2968,692
Wednesday,4,2017-11-29,4555,3484,2824,660
Thursday,5,2017-11-30,4477,3134,2530,604
Friday,6,2017-12-01,3577,2603,2056,547
Saturday,7,2017-12-02,2430,1827,1461,366
Sunday,1,2017-12-03,3449,2504,2006,498
Monday,2,2017-12-04,4955,3673,3019,654
Tuesday,3,2017-12-05,4475,3435,2775,660
Wednesday,4,2017-12-06,4595,3452,2766,686
Thursday,5,2017-12-07,4451,3199,2563,636
Friday,6,2017-12-08,3418,2549,2037,512
Saturday,7,2017-12-09,2605,1944,1572,372
Sunday,1,2017-12-10,3483,2607,2102,505
Monday,2,2017-12-11,4651,3350,2656,694
Tuesday,3,2017-12-12,4029,3011,2351,660
Wednesday,4,2017-12-13,4282,3205,2609,596
Thursday,5,2017-12-14,4138,2930,2315,615
Friday,6,2017-12-15,4130,2803,2211,592
Saturday,7,2017-12-16,2581,1761,1429,332
Sunday,1,2017-12-17,3355,2300,1876,424
Monday,2,2017-12-18,4482,3109,2491,618
Tuesday,3,2017-12-19,4584,3021,2456,565
Wednesday,4,2017-12-20,4106,2661,2133,528
Thursday,5,2017-12-21,3378,2243,1798,445
Friday,6,2017-12-22,2446,1544,1211,333
Saturday,7,2017-12-23,1447,958,753,205
Sunday,1,2017-12-24,1326,895,696,199
Monday,2,2017-12-25,1609,1015,809,206
Tuesday,3,2017-12-26,2481,1438,1105,333
Wednesday,4,2017-12-27,2798,1740,1350,390
Thursday,5,2017-12-28,2809,1797,1425,372
Friday,6,2017-12-29,2216,1410,1083,327
Saturday,7,2017-12-30,1546,1071,839,232
Sunday,1,2017-12-31,1339,923,724,199
Monday,2,2018-01-01,1709,1120,878,242
Tuesday,3,2018-01-02,3389,2208,1755,453
Wednesday,4,2018-01-03,3391,2282,1827,455
Thursday,5,2018-01-04,3698,2310,1878,432
Friday,6,2018-01-05,3511,2272,1801,471
Saturday,7,2018-01-06,2279,1498,1196,302
Sunday,1,2018-01-07,2822,1869,1495,374
Monday,2,2018-01-08,4240,2784,2186,598
Tuesday,3,2018-01-09,4319,2844,2302,542
Wednesday,4,2018-01-10,4224,2866,2304,562
Thursday,5,2018-01-11,3797,2704,2203,501
Friday,6,2018-01-12,3190,2127,1692,435
Saturday,7,2018-01-13,1998,1373,1128,245
Sunday,1,2018-01-14,2515,1711,1393,318
Monday,2,2018-01-15,3950,2612,2065,547
Tuesday,3,2018-01-16,4033,2631,2133,498
Wednesday,4,2018-01-17,4269,2812,2285,527
Thursday,5,2018-01-18,4124,2677,2157,520
Friday,6,2018-01-19,3228,2198,1763,435
Saturday,7,2018-01-20,2287,1423,1160,263
Sunday,1,2018-01-21,2946,1996,1628,368
Monday,2,2018-01-22,4608,3035,2534,501
Tuesday,3,2018-01-23,4786,3154,2566,588
Wednesday,4,2018-01-24,4724,3244,2680,564
Thursday,5,2018-01-25,4417,2875,2348,527
Friday,6,2018-01-26,3580,2314,1825,489
Saturday,7,2018-01-27,2345,1544,1229,315
Sunday,1,2018-01-28,3170,2140,1776,364
Monday,2,2018-01-29,4862,3194,2573,621
Tuesday,3,2018-01-30,4600,3106,2504,602
Wednesday,4,2018-01-31,4705,3249,2704,545
Thursday,5,2018-02-01,4723,3164,2571,593
Friday,6,2018-02-02,3969,2572,2104,468
Saturday,7,2018-02-03,2994,2034,1702,332
Sunday,1,2018-02-04,3162,2186,1811,375
Monday,2,2018-02-05,4949,3287,2735,552
Tuesday,3,2018-02-06,5092,3465,2838,627
Wednesday,4,2018-02-07,4767,3319,2729,590
Thursday,5,2018-02-08,4625,3179,2603,576
Friday,6,2018-02-09,3738,2477,2015,462
Saturday,7,2018-02-10,2739,1793,1477,316
Sunday,1,2018-02-11,3923,2476,2077,399
Monday,2,2018-02-12,5341,3687,3045,642
Tuesday,3,2018-02-13,5114,3460,2836,624
Wednesday,4,2018-02-14,4896,3214,2568,646
Thursday,5,2018-02-15,4502,3050,2507,543
Friday,6,2018-02-16,3729,2518,2012,506
Saturday,7,2018-02-17,2388,1618,1319,299
Sunday,1,2018-02-18,3405,2314,1928,386
Monday,2,2018-02-19,5176,3620,2971,649
Tuesday,3,2018-02-20,5429,3597,2978,619
Wednesday,4,2018-02-21,5120,3448,2869,579
Thursday,5,2018-02-22,4993,3379,2774,605
Friday,6,2018-02-23,4148,2751,2221,530
Saturday,7,2018-02-24,2763,1981,1648,333
Sunday,1,2018-02-25,3599,2446,2011,435
Monday,2,2018-02-26,5542,3728,3052,676
Tuesday,3,2018-02-27,5378,3764,3123,641
Wednesday,4,2018-02-28,5536,3734,3095,639
Thursday,5,2018-03-01,4984,3315,2713,602
Friday,6,2018-03-02,4130,2754,2231,523
Saturday,7,2018-03-03,2818,1922,1579,343
Sunday,1,2018-03-04,3978,2699,2249,450
Monday,2,2018-03-05,5502,3727,3019,708
Tuesday,3,2018-03-06,5740,3842,3160,682
Wednesday,4,2018-03-07,5635,3734,3037,697
Thursday,5,2018-03-08,5375,3704,3044,660
Friday,6,2018-03-09,4273,3038,2490,548
Saturday,7,2018-03-10,3223,2305,1918,387
Sunday,1,2018-03-11,3956,2727,2288,439
Monday,2,2018-03-12,5895,4141,3447,694
Tuesday,3,2018-03-13,6152,4207,3398,809
Wednesday,4,2018-03-14,5906,4021,3305,716
Thursday,5,2018-03-15,6300,4061,3279,782
Friday,6,2018-03-16,4915,3259,2673,586
Saturday,7,2018-03-17,3218,2161,1818,343
Sunday,1,2018-03-18,4429,2919,2435,484
Monday,2,2018-03-19,5739,4038,3316,722
Tuesday,3,2018-03-20,6220,4292,3553,739
Wednesday,4,2018-03-21,6238,4163,3396,767
Thursday,5,2018-03-22,6226,4251,3595,656
Friday,6,2018-03-23,4364,2994,2457,537
Saturday,7,2018-03-24,2882,2021,1682,339
Sunday,1,2018-03-25,4010,2748,2263,485
Monday,2,2018-03-26,6084,3995,3289,706
Tuesday,3,2018-03-27,5874,4147,3446,701
Wednesday,4,2018-03-28,5719,3917,3288,629
Thursday,5,2018-03-29,5003,3396,2812,584
Friday,6,2018-03-30,3605,2541,2062,479
Saturday,7,2018-03-31,2811,1901,1512,389
Sunday,1,2018-04-01,3567,2438,1956,482
Monday,2,2018-04-02,5237,3542,2875,667
Tuesday,3,2018-04-03,6154,4126,3438,688
Wednesday,4,2018-04-04,5895,4112,3418,694
Thursday,5,2018-04-05,5858,3943,3232,711
Friday,6,2018-04-06,5034,3348,2749,599
Saturday,7,2018-04-07,3613,2291,1840,451
Sunday,1,2018-04-08,4389,3059,2530,529
Monday,2,2018-04-09,6278,4290,3546,744
Tuesday,3,2018-04-10,6836,4514,3747,767
Wednesday,4,2018-04-11,6731,4596,3759,837
Thursday,5,2018-04-12,6287,4332,3563,769
Friday,6,2018-04-13,5089,3454,2850,604
Saturday,7,2018-04-14,3812,2542,2094,448
Sunday,1,2018-04-15,5290,3538,2914,624
Monday,2,2018-04-16,7161,4993,4188,805
Tuesday,3,2018-04-17,7352,4939,4058,881
Wednesday,4,2018-04-18,7218,4842,4001,841
Thursday,5,2018-04-19,7040,4672,3895,777
Friday,6,2018-04-20,5367,3728,3029,699
Saturday,7,2018-04-21,4021,2749,2253,496
Sunday,1,2018-04-22,5397,3722,3059,663
Monday,2,2018-04-23,7605,5124,4216,908
Tuesday,3,2018-04-24,7614,5094,4181,913
Wednesday,4,2018-04-25,7984,5541,4616,925
Thursday,5,2018-04-26,7040,4823,3957,866
Friday,6,2018-04-27,5628,3749,3095,654
Saturday,7,2018-04-28,3926,2618,2141,477
Sunday,1,2018-04-29,5479,3635,3057,578
Monday,2,2018-04-30,6670,4584,3784,800
Tuesday,3,2018-05-01,6783,4542,3742,800
Wednesday,4,2018-05-02,7105,4865,4013,852
Thursday,5,2018-05-03,6877,4702,3854,848
Friday,6,2018-05-04,5460,3711,3039,672
Saturday,7,2018-05-05,3648,2568,2058,510
Sunday,1,2018-05-06,4917,3311,2737,574
Monday,2,2018-05-07,6980,4654,3881,773
Tuesday,3,2018-05-08,6702,4577,3700,877
Wednesday,4,2018-05-09,6699,4488,3581,907
Thursday,5,2018-05-10,6001,4059,3265,794
Friday,6,2018-05-11,5094,3454,2766,688
Saturday,7,2018-05-12,3179,2237,1821,416
Sunday,1,2018-05-13,4169,2912,2413,499
Monday,2,2018-05-14,6392,4388,3637,751
Tuesday,3,2018-05-15,5878,4094,3384,710
Wednesday,4,2018-05-16,5800,3976,3266,710
Thursday,5,2018-05-17,5690,4023,3254,769
Friday,6,2018-05-18,4314,2986,2400,586
Saturday,7,2018-05-19,2948,2117,1735,382
Sunday,1,2018-05-20,3864,2674,2155,519
Monday,2,2018-05-21,5499,3708,3005,703
Tuesday,3,2018-05-22,5790,4040,3269,771
Wednesday,4,2018-05-23,5720,3971,3206,765
Thursday,5,2018-05-24,5692,3675,2965,710
Friday,6,2018-05-25,4082,2803,2188,615
Saturday,7,2018-05-26,2716,1965,1597,368
Sunday,1,2018-05-27,3430,2374,1887,487
Monday,2,2018-05-28,4353,2994,2392,602
Tuesday,3,2018-05-29,5525,3777,3112,665
Wednesday,4,2018-05-30,5407,3574,2908,666
Thursday,5,2018-05-31,4994,3485,2792,693
Friday,6,2018-06-01,3835,2681,2172,509
Saturday,7,2018-06-02,2511,1750,1423,327
Sunday,1,2018-06-03,3371,2308,1891,417
Monday,2,2018-06-04,5226,3399,2741,658
Tuesday,3,2018-06-05,5139,3453,2811,642
Wednesday,4,2018-06-06,5051,3474,2828,646
Thursday,5,2018-06-07,4787,3283,2685,598
Friday,6,2018-06-08,3956,2670,2107,563
Saturday,7,2018-06-09,2303,1589,1278,311
Sunday,1,2018-06-10,3011,2091,1717,374
Monday,2,2018-06-11,4896,3326,2714,612
Tuesday,3,2018-06-12,4952,3309,2624,685
Wednesday,4,2018-06-13,4570,3099,2439,660
Thursday,5,2018-06-14,4542,2962,2377,585
Friday,6,2018-06-15,3383,2320,1847,473
Saturday,7,2018-06-16,1922,1316,1061,255
Sunday,1,2018-06-17,2404,1677,1361,316
Monday,2,2018-06-18,4576,2964,2313,651
Tuesday,3,2018-06-19,4727,3144,2519,625
Wednesday,4,2018-06-20,4639,2989,2370,619
Thursday,5,2018-06-21,4108,2762,2154,608
Friday,6,2018-06-22,3372,2207,1744,463
Saturday,7,2018-06-23,1996,1277,989,288
Sunday,1,2018-06-24,2415,1619,1266,353
Monday,2,2018-06-25,4457,2881,2272,609
Tuesday,3,2018-06-26,4736,3039,2410,629
Wednesday,4,2018-06-27,4245,2818,2244,574
Thursday,5,2018-06-28,4081,2785,2160,625
Friday,6,2018-06-29,3053,2008,1568,440
Saturday,7,2018-06-30,1741,1147,927,220
Sunday,1,2018-07-01,2186,1447,1140,307
Monday,2,2018-07-02,4026,2533,1952,581
Tuesday,3,2018-07-03,3961,2515,1966,549
Wednesday,4,2018-07-04,3019,2032,1595,437
Thursday,5,2018-07-05,3743,2496,1997,499
Friday,6,2018-07-06,3050,1995,1575,420
Saturday,7,2018-07-07,1688,1080,857,223
Sunday,1,2018-07-08,2185,1440,1145,295
Monday,2,2018-07-09,4104,2576,2016,560
Tuesday,3,2018-07-10,4097,2694,2059,635
Wednesday,4,2018-07-11,3844,2506,1895,611
Thursday,5,2018-07-12,3743,2530,2001,529
Friday,6,2018-07-13,3073,2068,1581,487
Saturday,7,2018-07-14,1852,1249,992,257
Sunday,1,2018-07-15,2105,1474,1173,301
Monday,2,2018-07-16,4078,2657,2095,562
Tuesday,3,2018-07-17,4515,2856,2255,601
Wednesday,4,2018-07-18,4276,2779,2173,606
Thursday,5,2018-07-19,4043,2705,2114,591
Friday,6,2018-07-20,3004,2028,1576,452
Saturday,7,2018-07-21,1664,1177,942,235
Sunday,1,2018-07-22,2248,1561,1246,315
Monday,2,2018-07-23,4062,2658,2081,577
Tuesday,3,2018-07-24,4053,2680,2091,589
Wednesday,4,2018-07-25,3628,2431,1879,552
Thursday,5,2018-07-26,3596,2415,1925,490
Friday,6,2018-07-27,3140,2002,1539,463
Saturday,7,2018-07-28,1938,1304,1054,250
Sunday,1,2018-07-29,2460,1699,1364,335
Monday,2,2018-07-30,4175,2771,2166,605
Tuesday,3,2018-07-31,4113,2881,2310,571
Wednesday,4,2018-08-01,4273,2901,2310,591
Thursday,5,2018-08-02,4194,2754,2202,552
Friday,6,2018-08-03,3405,2345,1833,512
Saturday,7,2018-08-04,1800,1251,1025,226
Sunday,1,2018-08-05,2378,1694,1388,306
Monday,2,2018-08-06,4319,2856,2233,623
Tuesday,3,2018-08-07,4388,2971,2375,596
Wednesday,4,2018-08-08,4205,2724,2118,606
Thursday,5,2018-08-09,3973,2555,1998,557
Friday,6,2018-08-10,3510,2224,1777,447
Saturday,7,2018-08-11,1913,1281,1012,269
Sunday,1,2018-08-12,2397,1644,1284,360
Monday,2,2018-08-13,4348,2789,2224,565
Tuesday,3,2018-08-14,3966,2688,2127,561
Wednesday,4,2018-08-15,3805,2544,2035,509
Thursday,5,2018-08-16,3866,2604,2074,530
Friday,6,2018-08-17,3489,2219,1737,482
Saturday,7,2018-08-18,2074,1394,1108,286
Sunday,1,2018-08-19,2519,1687,1318,369
Monday,2,2018-08-20,4202,2734,2128,606
Tuesday,3,2018-08-21,4023,2711,2147,564
Wednesday,4,2018-08-22,4048,2685,2121,564
Thursday,5,2018-08-23,4150,2860,2249,611
Friday,6,2018-08-24,3154,2199,1742,457
Saturday,7,2018-08-25,2143,1317,1012,305
Sunday,1,2018-08-26,2576,1705,1372,333
Monday,2,2018-08-27,4317,2954,2367,587
Tuesday,3,2018-08-28,4421,3023,2427,596
Wednesday,4,2018-08-29,4563,3019,2395,624
Thursday,5,2018-08-30,4055,2798,2265,533
Friday,6,2018-08-31,3427,2305,1815,490
Saturday,7,2018-09-01,1731,1241,989,252
Sunday,1,2018-09-02,2258,1641,1293,348
Monday,2,2018-09-03,3655,2499,2032,467
Tuesday,3,2018-09-04,4456,2995,2435,560
Wednesday,4,2018-09-05,4566,3042,2456,586
Thursday,5,2018-09-06,4314,3049,2508,541
Friday,6,2018-09-07,3557,2349,1890,459
Saturday,7,2018-09-08,2281,1548,1255,293
Sunday,1,2018-09-09,3346,2255,1906,349
Monday,2,2018-09-10,4711,3200,2600,600
Tuesday,3,2018-09-11,4709,3134,2595,539
Wednesday,4,2018-09-12,4379,3032,2464,568
Thursday,5,2018-09-13,4357,2870,2325,545
Friday,6,2018-09-14,3560,2396,1907,489
Saturday,7,2018-09-15,2049,1488,1244,244
Sunday,1,2018-09-16,2813,1934,1614,320
Monday,2,2018-09-17,5064,3241,2621,620
Tuesday,3,2018-09-18,5006,3221,2595,626
Wednesday,4,2018-09-19,4949,3282,2708,574
Thursday,5,2018-09-20,4695,3165,2573,592
Friday,6,2018-09-21,3516,2383,1933,450
Saturday,7,2018-09-22,2460,1704,1374,330
Sunday,1,2018-09-23,2994,2127,1733,394
Monday,2,2018-09-24,4688,3273,2679,594
Tuesday,3,2018-09-25,4924,3481,2885,596
Wednesday,4,2018-09-26,5209,3546,2936,610
Thursday,5,2018-09-27,5966,4029,3385,644
Friday,6,2018-09-28,4740,3171,2643,528
Saturday,7,2018-09-29,2715,1870,1618,252
Sunday,1,2018-09-30,3739,2573,2194,379
Monday,2,2018-10-01,5841,3982,3331,651
Tuesday,3,2018-10-02,5881,4096,3514,582
Wednesday,4,2018-10-03,5540,3863,3249,614
Thursday,5,2018-10-04,5636,3894,3306,588
Friday,6,2018-10-05,4479,3120,2638,482
Saturday,7,2018-10-06,3076,2094,1750,344
Sunday,1,2018-10-07,3973,2865,2457,408
Monday,2,2018-10-08,6045,4310,3659,651
Tuesday,3,2018-10-09,6126,4173,3522,651
Wednesday,4,2018-10-10,6084,4319,3616,703
Thursday,5,2018-10-11,6154,4254,3632,622
Friday,6,2018-10-12,4868,3385,2784,601
Saturday,7,2018-10-13,3409,2379,2006,373
Sunday,1,2018-10-14,4722,3357,2859,498
Monday,2,2018-10-15,6555,4550,3766,784
Tuesday,3,2018-10-16,7079,4652,3893,759
Wednesday,4,2018-10-17,6691,4673,3893,780
Thursday,5,2018-10-18,6522,4398,3666,732
Friday,6,2018-10-19,4922,3390,2857,533
Saturday,7,2018-10-20,3409,2399,1990,409
Sunday,1,2018-10-21,4483,3092,2623,469
Monday,2,2018-10-22,6666,4499,3769,730
Tuesday,3,2018-10-23,6991,4677,3916,761
Wednesday,4,2018-10-24,6871,4619,3808,811
Thursday,5,2018-10-25,6357,4331,3579,752
Friday,6,2018-10-26,5114,3468,2827,641
Saturday,7,2018-10-27,3456,2400,2006,394
Sunday,1,2018-10-28,4924,3251,2735,516
Monday,2,2018-10-29,6837,4704,3890,814
Tuesday,3,2018-10-30,6481,4547,3798,749
Wednesday,4,2018-10-31,6296,4316,3545,771
Thursday,5,2018-11-01,6044,3988,3299,689
Friday,6,2018-11-02,4860,3326,2738,588
Saturday,7,2018-11-03,3430,2289,1946,343
Sunday,1,2018-11-04,4638,3236,2744,492
Monday,2,2018-11-05,6365,4329,3609,720
Tuesday,3,2018-11-06,6330,4291,3556,735
Wednesday,4,2018-11-07,5865,3937,3267,670
Thursday,5,2018-11-08,5692,3938,3298,640
Friday,6,2018-11-09,5026,3533,2917,616
Saturday,7,2018-11-10,3506,2428,2018,410
Sunday,1,2018-11-11,4778,3265,2709,556
Monday,2,2018-11-12,6684,4592,3795,797
Tuesday,3,2018-11-13,6766,4720,3918,802
Wednesday,4,2018-11-14,6916,4674,3872,802
Thursday,5,2018-11-15,6440,4379,3634,745
Friday,6,2018-11-16,5066,3497,2863,634
Saturday,7,2018-11-17,3503,2489,2043,446
Sunday,1,2018-11-18,4855,3321,2691,630
Monday,2,2018-11-19,6818,4601,3795,806
Tuesday,3,2018-11-20,6239,4424,3640,784
Wednesday,4,2018-11-21,5471,3904,3194,710
Thursday,5,2018-11-22,4453,3186,2592,594
Friday,6,2018-11-23,4062,2892,2347,545
Saturday,7,2018-11-24,3485,2445,1987,458
Sunday,1,2018-11-25,4906,3371,2815,556
Monday,2,2018-11-26,7099,4871,4012,859
Tuesday,3,2018-11-27,7503,5181,4267,914
Wednesday,4,2018-11-28,7554,5227,4330,897
Thursday,5,2018-11-29,7169,4944,4106,838
Friday,6,2018-11-30,5608,3895,3211,684
Saturday,7,2018-12-01,4055,2800,2306,494
Sunday,1,2018-12-02,5611,3906,3259,647
Monday,2,2018-12-03,7650,5378,4431,947
Tuesday,3,2018-12-04,7372,5225,4328,897
Wednesday,4,2018-12-05,7369,5166,4316,850
Thursday,5,2018-12-06,7250,5093,4213,880
Friday,6,2018-12-07,5735,4032,3296,736
Saturday,7,2018-12-08,4614,3240,2699,541
Sunday,1,2018-12-09,5979,4062,3352,710
Monday,2,2018-12-10,7840,5421,4465,956
Tuesday,3,2018-12-11,7659,5267,4330,937
Wednesday,4,2018-12-12,7319,4983,4010,973
Thursday,5,2018-12-13,6373,4452,3620,832
Friday,6,2018-12-14,4897,3404,2776,628
Saturday,7,2018-12-15,3325,2209,1833,376
Sunday,1,2018-12-16,3874,2671,2206,465
Monday,2,2018-12-17,5436,3791,3062,729
Tuesday,3,2018-12-18,5174,3562,2945,617
Wednesday,4,2018-12-19,4873,3255,2632,623
Thursday,5,2018-12-20,3913,2716,2164,552
Friday,6,2018-12-21,2934,1979,1543,436
Saturday,7,2018-12-22,1523,1074,846,228
Sunday,1,2018-12-23,1859,1223,997,226
Monday,2,2018-12-24,1835,1310,1019,291
Tuesday,3,2018-12-25,1852,1214,955,259
Wednesday,4,2018-12-26,2357,1594,1243,351
Thursday,5,2018-12-27,2583,1783,1418,365
Friday,6,2018-12-28,2477,1613,1279,334
Saturday,7,2018-12-29,1694,1197,990,207
Sunday,1,2018-12-30,1985,1340,1097,243
Monday,2,2018-12-31,1723,1159,874,285
Tuesday,3,2019-01-01,1715,1168,891,277
Wednesday,4,2019-01-02,3431,2361,1899,462
Thursday,5,2019-01-03,4118,2793,2259,534
Friday,6,2019-01-04,3504,2373,1936,437
Saturday,7,2019-01-05,2308,1609,1348,261
Sunday,1,2019-01-06,2925,2046,1648,398
Monday,2,2019-01-07,4587,3100,2550,550
Tuesday,3,2019-01-08,4731,3182,2585,597
Wednesday,4,2019-01-09,4831,3245,2660,585
Thursday,5,2019-01-10,4162,2836,2298,538
Friday,6,2019-01-11,3726,2476,1999,477
Saturday,7,2019-01-12,2458,1722,1413,309
Sunday,1,2019-01-13,3266,2264,1878,386
Monday,2,2019-01-14,5016,3348,2760,588
Tuesday,3,2019-01-15,4732,3320,2738,582
Wednesday,4,2019-01-16,4938,3447,2845,602
Thursday,5,2019-01-17,5033,3516,2967,549
Friday,6,2019-01-18,4114,2731,2236,495
Saturday,7,2019-01-19,2780,1929,1599,330
Sunday,1,2019-01-20,4205,2367,1974,393
Monday,2,2019-01-21,4983,3391,2783,608
Tuesday,3,2019-01-22,5182,3674,3052,622
Wednesday,4,2019-01-23,5316,3856,3199,657
Thursday,5,2019-01-24,5021,3462,2853,609
Friday,6,2019-01-25,4230,2882,2382,500
Saturday,7,2019-01-26,2743,1882,1541,341
Sunday,1,2019-01-27,3890,2622,2232,390
Monday,2,2019-01-28,5575,3925,3232,693
Tuesday,3,2019-01-29,5732,3866,3260,606
Wednesday,4,2019-01-30,5402,3759,3134,625
Thursday,5,2019-01-31,5069,3597,2984,613
Friday,6,2019-02-01,4222,2923,2364,559
Saturday,7,2019-02-02,2864,1902,1596,306
Sunday,1,2019-02-03,3598,2447,2044,403
Monday,2,2019-02-04,5366,3767,3146,621
Tuesday,3,2019-02-05,5427,3757,3124,633
Wednesday,4,2019-02-06,5667,3759,3130,629
Thursday,5,2019-02-07,5517,3763,3069,694
Friday,6,2019-02-08,4420,2943,2429,514
Saturday,7,2019-02-09,3150,2274,1911,363
Sunday,1,2019-02-10,4264,2962,2470,492
Monday,2,2019-02-11,6569,4276,3566,710
Tuesday,3,2019-02-12,6145,4092,3391,701
Wednesday,4,2019-02-13,5743,3932,3236,696
Thursday,5,2019-02-14,5512,3762,3075,687
Friday,6,2019-02-15,4127,2952,2377,575
Saturday,7,2019-02-16,3309,2195,1809,386
Sunday,1,2019-02-17,3761,2669,2217,452
Monday,2,2019-02-18,5592,3912,3226,686
Tuesday,3,2019-02-19,6100,4322,3575,747
Wednesday,4,2019-02-20,6208,4265,3543,722
Thursday,5,2019-02-21,5730,4071,3352,719
Friday,6,2019-02-22,4372,3073,2508,565
Saturday,7,2019-02-23,3378,2259,1871,388
Sunday,1,2019-02-24,4367,3012,2524,488
Monday,2,2019-02-25,6318,4424,3678,746
Tuesday,3,2019-02-26,6431,4304,3530,774
Wednesday,4,2019-02-27,5919,4205,3442,763
Thursday,5,2019-02-28,5668,3966,3266,700
Friday,6,2019-03-01,4581,3178,2594,584
Saturday,7,2019-03-02,3383,2263,1878,385
Sunday,1,2019-03-03,4311,3005,2476,529
Monday,2,2019-03-04,6357,4214,3443,771
Tuesday,3,2019-03-05,6092,4092,3343,749
Wednesday,4,2019-03-06,5772,4070,3340,730
Thursday,5,2019-03-07,5861,4064,3330,734
Friday,6,2019-03-08,4600,3147,2590,557
Saturday,7,2019-03-09,3390,2218,1849,369
Sunday,1,2019-03-10,4099,2898,2397,501
Monday,2,2019-03-11,6240,4320,3599,721
Tuesday,3,2019-03-12,5871,4127,3375,752
Wednesday,4,2019-03-13,6381,4506,3726,780
Thursday,5,2019-03-14,5853,4043,3328,715
Friday,6,2019-03-15,4425,3116,2499,617
Saturday,7,2019-03-16,2961,2099,1685,414
Sunday,1,2019-03-17,4008,2744,2258,486
Monday,2,2019-03-18,5830,4040,3319,721
Tuesday,3,2019-03-19,6089,4164,3448,716
Wednesday,4,2019-03-20,5800,3946,3192,754
Thursday,5,2019-03-21,5431,3761,3100,661
Friday,6,2019-03-22,4560,3071,2543,528
Saturday,7,2019-03-23,3256,2254,1859,395
Sunday,1,2019-03-24,4156,2858,2386,472
Monday,2,2019-03-25,6060,4232,3469,763
Tuesday,3,2019-03-26,6191,4344,3578,766
Wednesday,4,2019-03-27,6678,4612,3842,770
Thursday,5,2019-03-28,6167,4086,3361,725
Friday,6,2019-03-29,4441,3147,2601,546
Saturday,7,2019-03-30,3243,2325,1949,376
Sunday,1,2019-03-31,4260,3039,2543,496
Monday,2,2019-04-01,6078,4238,3550,688
Tuesday,3,2019-04-02,6824,4656,3833,823
Wednesday,4,2019-04-03,6621,4727,3942,785
Thursday,5,2019-04-04,6231,4343,3647,696
Friday,6,2019-04-05,4776,3346,2719,627
Saturday,7,2019-04-06,3148,2319,1924,395
Sunday,1,2019-04-07,4357,3050,2511,539
Monday,2,2019-04-08,6794,4738,3960,778
Tuesday,3,2019-04-09,6688,4505,3736,769
Wednesday,4,2019-04-10,6570,4448,3646,802
Thursday,5,2019-04-11,6113,4264,3504,760
Friday,6,2019-04-12,4856,3336,2726,610
Saturday,7,2019-04-13,3401,2409,2011,398
Sunday,1,2019-04-14,4551,3197,2600,597
Monday,2,2019-04-15,6614,4773,3967,806
Tuesday,3,2019-04-16,7019,4837,4037,800
Wednesday,4,2019-04-17,6643,4470,3681,789
Thursday,5,2019-04-18,5398,3825,3133,692
Friday,6,2019-04-19,4323,2981,2482,499
Saturday,7,2019-04-20,3546,2442,2020,422
Sunday,1,2019-04-21,4312,3045,2534,511
Monday,2,2019-04-22,6363,4520,3729,791
Tuesday,3,2019-04-23,6797,4968,4147,821
Wednesday,4,2019-04-24,7144,5002,4136,866
Thursday,5,2019-04-25,6555,4621,3804,817
Friday,6,2019-04-26,5400,3780,3089,691
Saturday,7,2019-04-27,3710,2465,2038,427
Sunday,1,2019-04-28,4788,3294,2728,566
Monday,2,2019-04-29,6232,4340,3578,762
Tuesday,3,2019-04-30,6093,4264,3440,824
Wednesday,4,2019-05-01,6117,4275,3556,719
Thursday,5,2019-05-02,6274,4153,3433,720
Friday,6,2019-05-03,4774,3370,2763,607
Saturday,7,2019-05-04,3437,2462,1999,463
Sunday,1,2019-05-05,4330,3009,2457,552
Monday,2,2019-05-06,5902,4164,3402,762
Tuesday,3,2019-05-07,6064,4258,3469,789
Wednesday,4,2019-05-08,5709,4049,3310,739
Thursday,5,2019-05-09,5596,3944,3275,669
Friday,6,2019-05-10,4498,3144,2494,650
Saturday,7,2019-05-11,3258,2119,1702,417
Sunday,1,2019-05-12,3571,2565,2070,495
Monday,2,2019-05-13,5677,3908,3136,772
Tuesday,3,2019-05-14,5534,3669,2977,692
Wednesday,4,2019-05-15,5391,3667,2989,678
Thursday,5,2019-05-16,5043,3577,2953,624
Friday,6,2019-05-17,3993,2795,2254,541
Saturday,7,2019-05-18,2565,1876,1545,331
Sunday,1,2019-05-19,3369,2364,1954,410
Monday,2,2019-05-20,4993,3442,2806,636
Tuesday,3,2019-05-21,4728,3406,2813,593
Wednesday,4,2019-05-22,4963,3431,2772,659
Thursday,5,2019-05-23,4637,3243,2698,545
Friday,6,2019-05-24,3694,2559,2070,489
Saturday,7,2019-05-25,2460,1658,1347,311
Sunday,1,2019-05-26,3006,2064,1693,371
Monday,2,2019-05-27,3992,2780,2271,509
Tuesday,3,2019-05-28,4960,3403,2767,636
Wednesday,4,2019-05-29,4376,3115,2562,553
Thursday,5,2019-05-30,4143,2896,2353,543
Friday,6,2019-05-31,3359,2363,1909,454
Saturday,7,2019-06-01,2218,1474,1221,253
Sunday,1,2019-06-02,2768,1845,1516,329
Monday,2,2019-06-03,3967,2831,2295,536
Tuesday,3,2019-06-04,4501,3008,2426,582
Wednesday,4,2019-06-05,3973,2727,2233,494
Thursday,5,2019-06-06,4259,2871,2312,559
Friday,6,2019-06-07,3181,2313,1869,444
Saturday,7,2019-06-08,2170,1583,1324,259
Sunday,1,2019-06-09,2810,1930,1586,344
Monday,2,2019-06-10,4420,3030,2463,567
Tuesday,3,2019-06-11,4793,3258,2664,594
Wednesday,4,2019-06-12,4410,3064,2479,585
Thursday,5,2019-06-13,4076,2844,2280,564
Friday,6,2019-06-14,3287,2265,1789,476
Saturday,7,2019-06-15,2176,1467,1201,266
Sunday,1,2019-06-16,2516,1747,1419,328
Monday,2,2019-06-17,4142,2925,2398,527
Tuesday,3,2019-06-18,4225,3013,2461,552
Wednesday,4,2019-06-19,4162,2882,2351,531
Thursday,5,2019-06-20,3716,2615,2137,478
Friday,6,2019-06-21,3333,2275,1853,422
Saturday,7,2019-06-22,1918,1360,1118,242
Sunday,1,2019-06-23,2344,1621,1317,304
Monday,2,2019-06-24,3691,2591,2149,442
Tuesday,3,2019-06-25,4035,2770,2247,523
Wednesday,4,2019-06-26,3939,2675,2186,489
Thursday,5,2019-06-27,3738,2671,2197,474
Friday,6,2019-06-28,2846,2021,1657,364
Saturday,7,2019-06-29,1733,1199,983,216
Sunday,1,2019-06-30,2184,1494,1240,254
Monday,2,2019-07-01,3512,2485,2001,484
Tuesday,3,2019-07-02,3675,2636,2163,473
Wednesday,4,2019-07-03,3831,2579,2144,435
Thursday,5,2019-07-04,2801,1971,1648,323
Friday,6,2019-07-05,2552,1790,1446,344
Saturday,7,2019-07-06,1950,1291,1110,181
Sunday,1,2019-07-07,2110,1477,1209,268
Monday,2,2019-07-08,4303,2903,2383,520
Tuesday,3,2019-07-09,3883,2799,2335,464
Wednesday,4,2019-07-10,4244,2907,2347,560
Thursday,5,2019-07-11,3765,2669,2150,519
Friday,6,2019-07-12,3286,2276,1816,460
Saturday,7,2019-07-13,1851,1305,1063,242
Sunday,1,2019-07-14,2580,1754,1433,321
Monday,2,2019-07-15,4140,2911,2382,529
Tuesday,3,2019-07-16,4076,2785,2285,500
Wednesday,4,2019-07-17,4141,2900,2360,540
Thursday,5,2019-07-18,3898,2774,2249,525
Friday,6,2019-07-19,3027,2078,1641,437
Saturday,7,2019-07-20,1831,1271,1033,238
Sunday,1,2019-07-21,2282,1617,1356,261
Monday,2,2019-07-22,4138,2890,2376,514
Tuesday,3,2019-07-23,4049,2868,2344,524
Wednesday,4,2019-07-24,4272,2963,2359,604
Thursday,5,2019-07-25,4089,2755,2210,545
Friday,6,2019-07-26,3277,2264,1842,422
Saturday,7,2019-07-27,1954,1308,1069,239
Sunday,1,2019-07-28,2111,1509,1239,270
Monday,2,2019-07-29,3625,2539,2053,486
Tuesday,3,2019-07-30,4415,2906,2386,520
Wednesday,4,2019-07-31,3854,2743,2260,483
Thursday,5,2019-08-01,4114,2771,2262,509
Friday,6,2019-08-02,3492,2280,1874,406
Saturday,7,2019-08-03,1849,1312,1096,216
Sunday,1,2019-08-04,2239,1630,1347,283
Monday,2,2019-08-05,3976,2664,2191,473
Tuesday,3,2019-08-06,4061,2833,2284,549
Wednesday,4,2019-08-07,3702,2675,2215,460
Thursday,5,2019-08-08,3622,2553,2112,441
Friday,6,2019-08-09,3039,2033,1660,373
Saturday,7,2019-08-10,1848,1265,1049,216
Sunday,1,2019-08-11,2082,1502,1242,260
Monday,2,2019-08-12,3807,2574,2121,453
Tuesday,3,2019-08-13,3993,2667,2215,452
Wednesday,4,2019-08-14,3567,2517,2087,430
Thursday,5,2019-08-15,3484,2450,2046,404
Friday,6,2019-08-16,2994,2022,1663,359
Saturday,7,2019-08-17,1793,1276,1074,202
Sunday,1,2019-08-18,2422,1721,1477,244
Monday,2,2019-08-19,4070,2847,2371,476
Tuesday,3,2019-08-20,3987,2800,2293,507
Wednesday,4,2019-08-21,3355,2407,1963,444
Thursday,5,2019-08-22,2925,1959,1627,332
Friday,6,2019-08-23,3010,2143,1769,374
Saturday,7,2019-08-24,1896,1380,1151,229
Sunday,1,2019-08-25,2501,1791,1497,294
Monday,2,2019-08-26,3851,2714,2257,457
Tuesday,3,2019-08-27,4403,3075,2622,453
Wednesday,4,2019-08-28,4627,3125,2623,502
Thursday,5,2019-08-29,4221,2982,2477,505
Friday,6,2019-08-30,3025,2102,1727,375
Saturday,7,2019-08-31,1998,1386,1179,207
Sunday,1,2019-09-01,2297,1645,1414,231
Monday,2,2019-09-02,3192,2272,1910,362
Tuesday,3,2019-09-03,4087,2921,2434,487
Wednesday,4,2019-09-04,4787,3348,2842,506
Thursday,5,2019-09-05,4483,3078,2570,508
Friday,6,2019-09-06,3571,2483,2095,388
Saturday,7,2019-09-07,2263,1566,1343,223
Sunday,1,2019-09-08,2948,2118,1827,291
Monday,2,2019-09-09,4521,3287,2785,502
Tuesday,3,2019-09-10,4563,3251,2758,493
Wednesday,4,2019-09-11,4598,3365,2901,464
Thursday,5,2019-09-12,4603,3356,2868,488
Friday,6,2019-09-13,3349,2508,2121,387
Saturday,7,2019-09-14,2437,1716,1451,265
Sunday,1,2019-09-15,3188,2367,2082,285
Monday,2,2019-09-16,5291,3839,3280,559
Tuesday,3,2019-09-17,5477,3815,3273,542
Wednesday,4,2019-09-18,5257,3726,3222,504
Thursday,5,2019-09-19,5000,3500,3028,472
Friday,6,2019-09-20,3890,2822,2407,415
Saturday,7,2019-09-21,2654,1994,1739,255
Sunday,1,2019-09-22,3656,2640,2328,312
Monday,2,2019-09-23,5223,3804,3291,513
Tuesday,3,2019-09-24,5276,3826,3287,539
Wednesday,4,2019-09-25,5476,3838,3306,532
Thursday,5,2019-09-26,5196,3718,3208,510
Friday,6,2019-09-27,4052,2863,2448,415
Saturday,7,2019-09-28,2635,1945,1696,249
Sunday,1,2019-09-29,4076,2895,2541,354
Monday,2,2019-09-30,5167,3754,3216,538
Tuesday,3,2019-10-01,4972,3634,3082,552
Wednesday,4,2019-10-02,5143,3683,3209,474
Thursday,5,2019-10-03,4753,3454,2941,513
Friday,6,2019-10-04,3795,2854,2440,414
Saturday,7,2019-10-05,2920,2118,1827,291
Sunday,1,2019-10-06,3950,2850,2471,379
Monday,2,2019-10-07,5493,3929,3432,497
Tuesday,3,2019-10-08,5652,4186,3705,481
Wednesday,4,2019-10-09,5617,3936,3388,548
Thursday,5,2019-10-10,5234,3802,3261,541
Friday,6,2019-10-11,4118,3147,2674,473
Saturday,7,2019-10-12,2863,2111,1803,308
Sunday,1,2019-10-13,4032,3013,2645,368
Monday,2,2019-10-14,5476,4022,3466,556
Tuesday,3,2019-10-15,5542,4117,3572,545
Wednesday,4,2019-10-16,5340,3966,3403,563
Thursday,5,2019-10-17,5388,3905,3333,572
Friday,6,2019-10-18,4309,3097,2675,422
Saturday,7,2019-10-19,3117,2223,1897,326
Sunday,1,2019-10-20,4234,3081,2679,402
Monday,2,2019-10-21,5698,4144,3507,637
Tuesday,3,2019-10-22,5721,4132,3536,596
Wednesday,4,2019-10-23,6018,4446,3823,623
Thursday,5,2019-10-24,5563,3995,3397,598
Friday,6,2019-10-25,4159,2961,2461,500
Saturday,7,2019-10-26,2732,2057,1753,304
Sunday,1,2019-10-27,3901,2854,2460,394
Monday,2,2019-10-28,5749,4120,3529,591
Tuesday,3,2019-10-29,5821,4140,3576,564
Wednesday,4,2019-10-30,5647,4059,3452,607
Thursday,5,2019-10-31,5219,3689,3180,509
Friday,6,2019-11-01,4054,3010,2604,406
Saturday,7,2019-11-02,2815,2170,1889,281
Sunday,1,2019-11-03,4253,3063,2603,460
Monday,2,2019-11-04,5816,4184,3640,544
Tuesday,3,2019-11-05,5843,4176,3549,627
Wednesday,4,2019-11-06,6058,4351,3672,679
Thursday,5,2019-11-07,6291,4489,3810,679
Friday,6,2019-11-08,4604,3357,2839,518
Saturday,7,2019-11-09,3354,2337,2000,337
Sunday,1,2019-11-10,4190,3075,2634,441
Monday,2,2019-11-11,5931,4194,3573,621
Tuesday,3,2019-11-12,6443,4589,3877,712
Wednesday,4,2019-11-13,5805,4275,3572,703
Thursday,5,2019-11-14,5753,4172,3569,603
Friday,6,2019-11-15,4709,3452,2927,525
Saturday,7,2019-11-16,3418,2506,2136,370
Sunday,1,2019-11-17,4821,3387,2872,515
Monday,2,2019-11-18,6444,4699,3985,714
Tuesday,3,2019-11-19,6607,4772,4119,653
Wednesday,4,2019-11-20,6726,4781,4115,666
Thursday,5,2019-11-21,6334,4462,3840,622
Friday,6,2019-11-22,4575,3214,2724,490
Saturday,7,2019-11-23,3414,2474,2118,356
Sunday,1,2019-11-24,4535,3242,2787,455
Monday,2,2019-11-25,5970,4467,3836,631
Tuesday,3,2019-11-26,5630,4115,3522,593
Wednesday,4,2019-11-27,5384,3823,3225,598
Thursday,5,2019-11-28,4201,3223,2747,476
Friday,6,2019-11-29,3799,2947,2504,443
Saturday,7,2019-11-30,3301,2443,2053,390
Sunday,1,2019-12-01,4420,3308,2849,459
Monday,2,2019-12-02,6384,4674,4031,643
Tuesday,3,2019-12-03,6964,4975,4285,690
Wednesday,4,2019-12-04,6957,4959,4252,707
Thursday,5,2019-12-05,6350,4671,3989,682
Friday,6,2019-12-06,5324,3796,3258,538
Saturday,7,2019-12-07,3795,2760,2362,398
Sunday,1,2019-12-08,5013,3636,3159,477
Monday,2,2019-12-09,7005,5250,4569,681
Tuesday,3,2019-12-10,6606,4791,4131,660
Wednesday,4,2019-12-11,6686,4902,4240,662
Thursday,5,2019-12-12,6163,4533,3871,662
Friday,6,2019-12-13,4581,3272,2801,471
Saturday,7,2019-12-14,2930,2240,1958,282
Sunday,1,2019-12-15,3585,2672,2280,392
Monday,2,2019-12-16,4925,3653,3128,525
Tuesday,3,2019-12-17,4743,3441,2895,546
Wednesday,4,2019-12-18,4716,3390,2918,472
Thursday,5,2019-12-19,3793,2821,2381,440
Friday,6,2019-12-20,2688,1906,1583,323
Saturday,7,2019-12-21,1682,1177,1020,157
Sunday,1,2019-12-22,1880,1411,1190,221
Monday,2,2019-12-23,2451,1738,1442,296
Tuesday,3,2019-12-24,1644,1197,977,220
Wednesday,4,2019-12-25,1483,1027,851,176
Thursday,5,2019-12-26,1864,1355,1102,253
Friday,6,2019-12-27,1927,1319,1109,210
Saturday,7,2019-12-28,1679,1219,1019,200
Sunday,1,2019-12-29,1962,1299,1111,188
Monday,2,2019-12-30,2469,1762,1479,283
Tuesday,3,2019-12-31,1750,1192,1005,187
Wednesday,4,2020-01-01,1554,1105,870,235
Thursday,5,2020-01-02,2820,2083,1754,329
Friday,6,2020-01-03,2970,2180,1859,321
Saturday,7,2020-01-04,2111,1526,1300,226
Sunday,1,2020-01-05,2393,1788,1514,274
Monday,2,2020-01-06,3704,2770,2341,429
Tuesday,3,2020-01-07,3760,2915,2492,423
Wednesday,4,2020-01-08,3698,2844,2402,442
Thursday,5,2020-01-09,4243,3374,2910,464
Friday,6,2020-01-10,3177,2415,2043,372
Saturday,7,2020-01-11,2361,1834,1581,253
Sunday,1,2020-01-12,2762,2238,1961,277
Monday,2,2020-01-13,4298,3242,2727,515
Tuesday,3,2020-01-14,3838,2884,2450,434
Wednesday,4,2020-01-15,3754,2864,2470,394
Thursday,5,2020-01-16,3817,2951,2510,441
Friday,6,2020-01-17,3175,2419,2006,413
Saturday,7,2020-01-18,2336,1927,1681,246
Sunday,1,2020-01-19,2597,2031,1717,314
Monday,2,2020-01-20,3715,2948,2505,443
Tuesday,3,2020-01-21,4459,3501,3017,484
Wednesday,4,2020-01-22,4483,3552,3079,473
Thursday,5,2020-01-23,4225,3295,2805,490
Friday,6,2020-01-24,3111,2484,2131,353
Saturday,7,2020-01-25,2353,1784,1535,249
Sunday,1,2020-01-26,3198,2520,2213,307
Monday,2,2020-01-27,4432,3539,3058,481
Tuesday,3,2020-01-28,4664,3654,3148,506
Wednesday,4,2020-01-29,4471,3544,3025,519
Thursday,5,2020-01-30,4486,3499,3031,468
Friday,6,2020-01-31,3527,2704,2304,400
Saturday,7,2020-02-01,2514,1995,1728,267
Sunday,1,2020-02-02,2993,2409,2106,303
Monday,2,2020-02-03,4728,3694,3174,520
Tuesday,3,2020-02-04,4883,3982,3472,510
Wednesday,4,2020-02-05,5071,4061,3528,533
Thursday,5,2020-02-06,4638,3715,3217,498
Friday,6,2020-02-07,3757,2942,2512,430
Saturday,7,2020-02-08,2761,2193,1890,303
Sunday,1,2020-02-09,3423,2849,2498,351
Monday,2,2020-02-10,5066,4016,3464,552
Tuesday,3,2020-02-11,4928,4045,3499,546
Wednesday,4,2020-02-12,4996,4019,3497,522
Thursday,5,2020-02-13,5004,3823,3188,635
Friday,6,2020-02-14,3675,2949,2529,420
Saturday,7,2020-02-15,2556,2024,1757,267
Sunday,1,2020-02-16,3732,2808,2361,447
Monday,2,2020-02-17,4958,3951,3382,569
Tuesday,3,2020-02-18,4869,3806,3273,533
Wednesday,4,2020-02-19,5224,4042,3495,547
Thursday,5,2020-02-20,4890,3748,3212,536
Friday,6,2020-02-21,3678,2914,2528,386
Saturday,7,2020-02-22,2456,2025,1759,266
Sunday,1,2020-02-23,3444,2708,2387,321
Monday,2,2020-02-24,5000,3974,3390,584
Tuesday,3,2020-02-25,5496,4210,3601,609
Wednesday,4,2020-02-26,5059,4014,3468,546
Thursday,5,2020-02-27,4813,3759,3247,512
Friday,6,2020-02-28,3810,3052,2569,483
Saturday,7,2020-02-29,2682,2169,1858,311
Sunday,1,2020-03-01,3332,2754,2379,375
Monday,2,2020-03-02,4872,3801,3264,537
Tuesday,3,2020-03-03,5097,3956,3452,504
Wednesday,4,2020-03-04,4714,3591,3118,473
Thursday,5,2020-03-05,5048,3994,3428,566
Friday,6,2020-03-06,3698,2843,2386,457
Saturday,7,2020-03-07,2670,2095,1798,297
Sunday,1,2020-03-08,3416,2743,2362,381
Monday,2,2020-03-09,4731,3830,3269,561
Tuesday,3,2020-03-10,4820,3718,3169,549
Wednesday,4,2020-03-11,4813,3711,3182,529
Thursday,5,2020-03-12,4393,3508,2952,556
Friday,6,2020-03-13,3316,2613,2172,441
Saturday,7,2020-03-14,2416,1888,1569,319
Sunday,1,2020-03-15,2934,2251,1937,314
Monday,2,2020-03-16,2732,2157,1809,348
Tuesday,3,2020-03-17,3805,3007,2525,482
Wednesday,4,2020-03-18,3748,2976,2508,468
Thursday,5,2020-03-19,3678,2883,2471,412
Friday,6,2020-03-20,3322,2647,2239,408
Saturday,7,2020-03-21,2701,2049,1749,300
Sunday,1,2020-03-22,3263,2469,2120,349
Monday,2,2020-03-23,4105,3166,2690,476
Tuesday,3,2020-03-24,4156,3247,2766,481
Wednesday,4,2020-03-25,4153,3367,2878,489
Thursday,5,2020-03-26,4256,3394,2944,450
Friday,6,2020-03-27,3818,3002,2588,414
Saturday,7,2020-03-28,3045,2438,2103,335
Sunday,1,2020-03-29,4079,3047,2603,444
Monday,2,2020-03-30,4899,3852,3280,572
Tuesday,3,2020-03-31,4943,3822,3310,512
Wednesday,4,2020-04-01,4907,3799,3317,482
Thursday,5,2020-04-02,4933,3838,3305,533
Friday,6,2020-04-03,4665,3498,2975,523
Saturday,7,2020-04-04,3366,2536,2175,361
Sunday,1,2020-04-05,3976,3045,2644,401
Monday,2,2020-04-06,4981,3921,3351,570
Tuesday,3,2020-04-07,5331,4144,3552,592
Wednesday,4,2020-04-08,5331,4203,3656,547
Thursday,5,2020-04-09,5063,3982,3426,556
Friday,6,2020-04-10,4252,3354,2869,485
Saturday,7,2020-04-11,3656,2712,2279,433
Sunday,1,2020-04-12,4152,3125,2666,459
Monday,2,2020-04-13,5089,3922,3379,543
Tuesday,3,2020-04-14,5491,4314,3721,593
Wednesday,4,2020-04-15,5665,4424,3754,670
Thursday,5,2020-04-16,5423,4203,3592,611
Friday,6,2020-04-17,4688,3682,3146,536
Saturday,7,2020-04-18,4055,3007,2521,486
Sunday,1,2020-04-19,4830,3671,3057,614
Monday,2,2020-04-20,5908,4517,3869,648
Tuesday,3,2020-04-21,5633,4377,3722,655
Wednesday,4,2020-04-22,5786,4520,3856,664
Thursday,5,2020-04-23,5967,4758,4074,684
Friday,6,2020-04-24,4937,3879,3319,560
Saturday,7,2020-04-25,4327,3284,2814,470
Sunday,1,2020-04-26,5086,3964,3393,571
Monday,2,2020-04-27,6038,4771,4054,717
Tuesday,3,2020-04-28,6324,4920,4210,710
Wednesday,4,2020-04-29,6062,4735,4006,729
Thursday,5,2020-04-30,5520,4375,3776,599
Friday,6,2020-05-01,4670,3621,3068,553
Saturday,7,2020-05-02,4171,3145,2683,462
Sunday,1,2020-05-03,4716,3648,3067,581
Monday,2,2020-05-04,5939,4567,3882,685
Tuesday,3,2020-05-05,6361,4900,4169,731
Wednesday,4,2020-05-06,6659,5322,4580,742
Thursday,5,2020-05-07,6264,4857,4067,790
Friday,6,2020-05-08,5359,4202,3592,610
Saturday,7,2020-05-09,4593,3452,2932,520
Sunday,1,2020-05-10,5092,3917,3338,579
Monday,2,2020-05-11,6563,5112,4278,834
Tuesday,3,2020-05-12,6124,4775,4028,747
Wednesday,4,2020-05-13,5817,4596,3886,710
Thursday,5,2020-05-14,6057,4583,3937,646
Friday,6,2020-05-15,4958,3829,3183,646
Saturday,7,2020-05-16,3651,2827,2384,443
Sunday,1,2020-05-17,4248,3291,2737,554
Monday,2,2020-05-18,5624,4231,3588,643
Tuesday,3,2020-05-19,5595,4300,3666,634
Wednesday,4,2020-05-20,5213,4106,3466,640
Thursday,5,2020-05-21,5156,3990,3372,618
Friday,6,2020-05-22,4350,3343,2816,527
Saturday,7,2020-05-23,3446,2696,2291,405
Sunday,1,2020-05-24,3945,2969,2479,490
Monday,2,2020-05-25,4639,3610,3054,556
Tuesday,3,2020-05-26,5224,4069,3416,653
Wednesday,4,2020-05-27,5242,4105,3474,631
Thursday,5,2020-05-28,4939,3966,3371,595
Friday,6,2020-05-29,4387,3486,2949,537
Saturday,7,2020-05-30,3327,2583,2189,394
Sunday,1,2020-05-31,3692,2919,2482,437
Monday,2,2020-06-01,4734,3707,3133,574
Tuesday,3,2020-06-02,4727,3690,3057,633
Wednesday,4,2020-06-03,4994,3869,3239,630
Thursday,5,2020-06-04,4767,3733,3156,577
Friday,6,2020-06-05,4124,3247,2778,469
Saturday,7,2020-06-06,3230,2425,2045,380
Sunday,1,2020-06-07,3906,3049,2574,475
Monday,2,2020-06-08,4895,3787,3188,599
Tuesday,3,2020-06-09,4871,3644,3050,594
Wednesday,4,2020-06-10,4989,3857,3269,588
Thursday,5,2020-06-11,4633,3560,3015,545
Friday,6,2020-06-12,4475,3292,2757,535
Saturday,7,2020-06-13,2967,2304,1942,362
Sunday,1,2020-06-14,3507,2684,2282,402
Monday,2,2020-06-15,4337,3348,2794,554
Tuesday,3,2020-06-16,4470,3461,2964,497
Wednesday,4,2020-06-17,4439,3450,2898,552
Thursday,5,2020-06-18,4895,3677,3132,545
Friday,6,2020-06-19,3924,2911,2459,452
Saturday,7,2020-06-20,2827,2190,1851,339
Sunday,1,2020-06-21,3481,2668,2256,412
Monday,2,2020-06-22,4627,3493,2935,558
Tuesday,3,2020-06-23,4561,3493,2950,543
Wednesday,4,2020-06-24,4626,3521,2982,539
Thursday,5,2020-06-25,4137,3215,2668,547
Friday,6,2020-06-26,3555,2675,2248,427
Saturday,7,2020-06-27,2671,1999,1680,319
Sunday,1,2020-06-28,3486,2635,2233,402
Monday,2,2020-06-29,4000,3119,2616,503
Tuesday,3,2020-06-30,3828,3013,2553,460
Wednesday,4,2020-07-01,3935,3049,2599,450
Thursday,5,2020-07-02,3633,2881,2397,484
Friday,6,2020-07-03,2997,2286,1932,354
Saturday,7,2020-07-04,2194,1704,1420,284
Sunday,1,2020-07-05,2948,2198,1836,362
Monday,2,2020-07-06,4049,3215,2724,491
Tuesday,3,2020-07-07,3792,2998,2485,513
Wednesday,4,2020-07-08,4029,3096,2613,483
Thursday,5,2020-07-09,3945,3039,2587,452
Friday,6,2020-07-10,3523,2620,2173,447
Saturday,7,2020-07-11,2646,1981,1665,316
Sunday,1,2020-07-12,3454,2611,2213,398
Monday,2,2020-07-13,3703,2916,2459,457
Tuesday,3,2020-07-14,3680,2853,2397,456
Wednesday,4,2020-07-15,3479,2627,2196,431
Thursday,5,2020-07-16,3756,2916,2463,453
Friday,6,2020-07-17,3289,2557,2122,435
Saturday,7,2020-07-18,2416,1892,1606,286
Sunday,1,2020-07-19,2793,2197,1892,305
Monday,2,2020-07-20,3749,2881,2428,453
Tuesday,3,2020-07-21,3786,2889,2450,439
Wednesday,4,2020-07-22,4002,3039,2566,473
Thursday,5,2020-07-23,3823,3033,2525,508
Friday,6,2020-07-24,3430,2623,2262,361
Saturday,7,2020-07-25,2400,1767,1487,280
Sunday,1,2020-07-26,2835,2207,1869,338
Monday,2,2020-07-27,4001,3031,2523,508
Tuesday,3,2020-07-28,3795,2969,2525,444
Wednesday,4,2020-07-29,3903,3010,2591,419
Thursday,5,2020-07-30,3397,2687,2265,422
Friday,6,2020-07-31,3005,2317,1887,430
Saturday,7,2020-08-01,2305,1750,1479,271
Sunday,1,2020-08-02,2696,1993,1701,292
Monday,2,2020-08-03,3866,2814,2368,446
Tuesday,3,2020-08-04,3826,2845,2400,445
Wednesday,4,2020-08-05,3673,2774,2334,440
Thursday,5,2020-08-06,3660,2625,2189,436
Friday,6,2020-08-07,3136,2364,1941,423
Saturday,7,2020-08-08,2223,1628,1354,274
Sunday,1,2020-08-09,2623,1941,1644,297
Monday,2,2020-08-10,3638,2745,2325,420
Tuesday,3,2020-08-11,3740,2742,2258,484
Wednesday,4,2020-08-12,3767,2904,2477,427
Thursday,5,2020-08-13,3621,2780,2322,458
Friday,6,2020-08-14,2971,2308,1922,386
Saturday,7,2020-08-15,2221,1696,1373,323
Sunday,1,2020-08-16,2724,2037,1686,351
Monday,2,2020-08-17,3456,2638,2181,457
Tuesday,3,2020-08-18,3581,2683,2184,499
